geoid,name,B07003001,"B07003001, Error",B07003002,"B07003002, Error",B07003003,"B07003003, Error",B07003004,"B07003004, Error",B07003005,"B07003005, Error",B07003006,"B07003006, Error",B07003007,"B07003007, Error",B07003008,"B07003008, Error",B07003009,"B07003009, Error",B07003010,"B07003010, Error",B07003011,"B07003011, Error",B07003012,"B07003012, Error",B07003013,"B07003013, Error",B07003014,"B07003014, Error",B07003015,"B07003015, Error",B07003016,"B07003016, Error",B07003017,"B07003017, Error",B07003018,"B07003018, Error"
04000US08,Colorado,5625572,1641,2831125,1693,2794447,1535,4635646,12098,2324060,6212,2311586,7437,452500,8631,229292,5020,223208,5003,279217,6387,143562,3751,135655,3838,226020,5983,117403,3657,108617,3151,32189,2180,16808,1227,15381,1296
14000US08001007801,"Census Tract 78.01, Adams, CO",4224,640,2178,371,2046,363,3109,626,1665,388,1444,320,152,86,73,52,79,65,548,253,238,108,310,173,43,32,24,22,19,20,372,287,178,140,194,154
14000US08001007802,"Census Tract 78.02, Adams, CO",4473,770,2196,473,2277,410,3603,697,1868,451,1735,345,224,214,80,75,144,148,295,171,106,66,189,134,131,103,96,73,35,34,220,162,46,55,174,150
14000US08001007900,"Census Tract 79, Adams, CO",5548,693,2847,377,2701,445,4662,576,2466,337,2196,360,186,112,40,44,146,93,585,296,254,151,331,186,13,22,13,22,0,17,102,89,74,57,28,45
14000US08001008000,"Census Tract 80, Adams, CO",5643,992,2733,458,2910,619,4951,1025,2376,483,2575,624,107,123,101,120,6,8,536,264,217,122,319,167,37,37,35,37,2,4,12,14,4,9,8,12
14000US08001008100,"Census Tract 81, Adams, CO",1440,193,715,163,725,145,932,156,463,136,469,116,104,93,59,68,45,64,144,53,56,23,88,41,248,110,128,69,120,73,12,12,9,11,3,5
14000US08001008200,"Census Tract 82, Adams, CO",6587,1024,3554,843,3033,329,5438,964,2787,717,2651,364,253,203,157,160,96,140,702,367,503,305,199,96,174,115,87,54,87,79,20,34,20,34,0,17
14000US08001008308,"Census Tract 83.08, Adams, CO",5837,855,2740,489,3097,477,4782,807,2155,459,2627,436,219,203,158,150,61,58,748,473,383,234,365,279,49,69,28,38,21,33,39,45,16,26,23,37
14000US08001008309,"Census Tract 83.09, Adams, CO",4038,640,2091,452,1947,274,3124,482,1575,304,1549,255,40,46,3,5,37,45,765,473,494,326,271,180,16,27,0,12,16,27,93,133,19,31,74,103
14000US08001008401,"Census Tract 84.01, Adams, CO",5293,458,2753,269,2540,330,4726,485,2432,277,2294,327,220,145,114,78,106,98,269,163,158,93,111,82,78,55,49,51,29,30,0,17,0,17,0,17
14000US08001008402,"Census Tract 84.02, Adams, CO",4775,622,2317,394,2458,319,4303,620,2045,392,2258,310,105,115,45,58,60,61,229,149,152,103,77,55,100,90,47,42,53,52,38,45,28,41,10,15
14000US08001008505,"Census Tract 85.05, Adams, CO",7320,776,3894,459,3426,457,6654,742,3507,427,3147,443,285,180,160,116,125,98,338,243,206,163,132,120,43,66,21,33,22,33,0,17,0,17,0,17
14000US08001008506,"Census Tract 85.06, Adams, CO",6527,879,3188,620,3339,543,4417,887,2177,611,2240,483,1649,626,782,323,867,370,291,210,154,112,137,107,131,115,56,59,75,72,39,72,19,36,20,36
14000US08001008507,"Census Tract 85.07, Adams, CO",6591,1108,3358,655,3233,634,5361,1140,2824,725,2537,512,722,460,387,228,335,266,508,427,147,162,361,302,0,17,0,17,0,17,0,17,0,17,0,17
14000US08001008508,"Census Tract 85.08, Adams, CO",5770,885,2810,433,2960,528,5091,864,2411,405,2680,530,414,204,234,161,180,95,106,68,47,39,59,48,79,57,71,54,8,13,80,85,47,66,33,55
14000US08001008524,"Census Tract 85.24, Adams, CO",9528,940,5032,668,4496,480,8250,856,4204,593,4046,468,695,446,507,352,188,110,421,192,243,133,178,105,162,153,78,71,84,89,0,17,0,17,0,17
14000US08001008526,"Census Tract 85.26, Adams, CO",7155,881,3507,548,3648,497,6296,806,3157,497,3139,458,306,209,109,110,197,130,271,211,124,89,147,150,282,221,117,108,165,124,0,17,0,17,0,17
14000US08001008533,"Census Tract 85.33, Adams, CO",8469,1029,4181,580,4288,705,6974,1077,3324,608,3650,700,612,290,353,168,259,162,620,391,384,220,236,180,244,217,120,101,124,126,19,30,0,17,19,30
14000US08001008534,"Census Tract 85.34, Adams, CO",4779,641,2443,407,2336,331,4254,617,2172,383,2082,311,258,189,119,104,139,131,82,60,61,43,21,24,185,196,91,86,94,113,0,12,0,12,0,12
14000US08001008535,"Census Tract 85.35, Adams, CO",3934,578,2007,336,1927,327,3013,594,1560,367,1453,279,378,252,198,128,180,157,325,195,158,122,167,99,218,119,91,73,127,69,0,12,0,12,0,12
14000US08001008536,"Census Tract 85.36, Adams, CO",3686,459,1744,287,1942,249,3084,436,1450,252,1634,255,275,207,129,111,146,105,247,130,99,63,148,78,15,19,1,6,14,17,65,94,65,94,0,12
14000US08001008538,"Census Tract 85.38, Adams, CO",8299,922,4250,507,4049,538,7433,862,3834,511,3599,449,477,291,217,131,260,183,124,101,73,57,51,53,257,219,118,99,139,123,8,33,8,33,0,17
14000US08001008540,"Census Tract 85.40, Adams, CO",8925,1314,4509,1081,4416,525,7950,1209,4072,913,3878,523,476,286,312,219,164,103,109,100,30,47,79,89,390,358,95,85,295,282,0,17,0,17,0,17
14000US08001008544,"Census Tract 85.44, Adams, CO",6045,723,2658,345,3387,536,5210,772,2396,351,2814,527,468,247,108,104,360,201,242,166,100,60,142,115,89,68,26,27,63,57,36,59,28,46,8,14
14000US08001008545,"Census Tract 85.45, Adams, CO",7143,782,3477,458,3666,434,6404,620,3102,377,3302,378,318,194,166,115,152,104,202,149,89,124,113,85,219,178,120,94,99,98,0,17,0,17,0,17
14000US08001008546,"Census Tract 85.46, Adams, CO",4291,714,2265,333,2026,529,3542,742,1934,358,1608,504,345,213,182,112,163,125,147,88,41,47,106,74,257,195,108,80,149,140,0,12,0,12,0,12
14000US08001008547,"Census Tract 85.47, Adams, CO",3040,514,1453,312,1587,264,2642,540,1253,333,1389,267,201,119,132,84,69,56,94,77,42,41,52,42,93,138,26,42,67,96,10,17,0,12,10,17
14000US08001008548,"Census Tract 85.48, Adams, CO",1725,244,802,186,923,116,1453,241,607,180,846,124,115,76,85,59,30,37,93,52,63,44,30,22,64,53,47,39,17,18,0,12,0,12,0,12
14000US08001008549,"Census Tract 85.49, Adams, CO",3845,743,2218,546,1627,299,3080,788,1758,564,1322,305,461,257,285,175,176,93,256,134,154,73,102,82,44,48,21,23,23,25,4,7,0,12,4,7
14000US08001008550,"Census Tract 85.50, Adams, CO",8158,1189,4132,663,4026,625,7089,1192,3603,657,3486,621,760,360,390,198,370,201,160,119,58,51,102,77,149,139,81,69,68,77,0,17,0,17,0,17
14000US08001008551,"Census Tract 85.51, Adams, CO",1679,270,804,154,875,140,1559,257,736,143,823,139,93,76,52,39,41,40,20,18,15,17,5,8,7,9,1,3,6,8,0,12,0,12,0,12
14000US08001008603,"Census Tract 86.03, Adams, CO",1848,356,760,154,1088,264,1538,248,630,142,908,200,136,130,23,29,113,130,65,46,52,43,13,15,109,78,55,43,54,56,0,12,0,12,0,12
14000US08001008604,"Census Tract 86.04, Adams, CO",5380,793,3203,509,2177,426,3634,674,1855,367,1779,423,813,284,602,217,211,90,660,185,526,146,134,83,260,162,207,136,53,47,13,25,13,25,0,17
14000US08001008605,"Census Tract 86.05, Adams, CO",3964,745,2102,476,1862,399,3612,715,1943,430,1669,390,183,122,88,84,95,74,131,115,43,48,88,89,38,40,28,35,10,17,0,12,0,12,0,12
14000US08001008606,"Census Tract 86.06, Adams, CO",5734,801,2854,449,2880,499,5195,721,2564,439,2631,466,332,227,156,128,176,129,138,139,98,122,40,69,69,66,36,41,33,37,0,17,0,17,0,17
14000US08001008705,"Census Tract 87.05, Adams, CO",5307,854,2626,439,2681,520,4887,918,2382,473,2505,532,176,93,90,53,86,64,240,168,150,113,90,71,4,9,4,9,0,17,0,17,0,17,0,17
14000US08001008706,"Census Tract 87.06, Adams, CO",5599,902,2639,481,2960,667,4630,714,2459,492,2171,386,623,541,55,50,568,524,216,155,81,73,135,94,96,94,37,44,59,76,34,46,7,11,27,44
14000US08001008709,"Census Tract 87.09, Adams, CO",7634,1073,3537,457,4097,883,6183,825,2816,463,3367,637,382,285,167,133,215,170,924,670,414,214,510,557,94,61,89,59,5,16,51,75,51,75,0,17
14000US08001008801,"Census Tract 88.01, Adams, CO",4896,700,2445,433,2451,376,4339,677,2187,416,2152,361,359,192,160,108,199,111,138,91,59,47,79,88,60,63,39,58,21,23,0,12,0,12,0,12
14000US08001008802,"Census Tract 88.02, Adams, CO",5384,971,3083,590,2301,479,4660,938,2657,580,2003,464,358,230,215,145,143,127,220,118,134,70,86,75,106,105,37,42,69,94,40,44,40,44,0,17
14000US08001008901,"Census Tract 89.01, Adams, CO",2679,480,1416,292,1263,225,2316,497,1243,302,1073,225,130,75,57,46,73,41,181,137,69,53,112,91,52,39,47,35,5,9,0,12,0,12,0,12
14000US08001009001,"Census Tract 90.01, Adams, CO",4504,683,2235,402,2269,429,3830,576,1938,347,1892,360,438,310,158,131,280,212,150,115,106,84,44,58,6,13,0,12,6,13,80,111,33,40,47,73
14000US08001009101,"Census Tract 91.01, Adams, CO",4936,702,2542,484,2394,347,4381,753,2239,494,2142,365,448,228,249,138,199,130,78,72,25,30,53,56,29,37,29,37,0,17,0,17,0,17,0,17
14000US08001009103,"Census Tract 91.03, Adams, CO",4641,819,2247,530,2394,388,4056,756,1967,484,2089,392,347,262,201,159,146,141,98,112,33,40,65,75,84,116,45,63,39,53,56,56,1,2,55,56
14000US08001009104,"Census Tract 91.04, Adams, CO",6291,1258,2754,401,3537,943,5145,780,2275,304,2870,593,467,277,213,139,254,160,460,642,111,145,349,499,205,129,141,93,64,55,14,24,14,24,0,17
14000US08001009202,"Census Tract 92.02, Adams, CO",4609,733,2199,372,2410,519,4255,762,2039,373,2216,545,154,107,80,46,74,69,147,108,32,23,115,93,53,55,48,47,5,9,0,12,0,12,0,12
14000US08001009203,"Census Tract 92.03, Adams, CO",5570,967,3230,615,2340,450,3187,503,1890,312,1297,270,1882,944,997,580,885,416,334,165,235,132,99,64,167,137,108,114,59,48,0,17,0,17,0,17
14000US08001009204,"Census Tract 92.04, Adams, CO",6785,907,3500,634,3285,437,5196,926,2459,584,2737,434,759,473,531,381,228,168,589,363,445,301,144,110,241,174,65,63,176,133,0,17,0,17,0,17
14000US08001009206,"Census Tract 92.06, Adams, CO",2568,334,1136,163,1432,267,2238,325,1008,161,1230,258,187,154,87,95,100,80,58,38,18,19,40,27,85,57,23,27,62,52,0,12,0,12,0,12
14000US08001009207,"Census Tract 92.07, Adams, CO",4992,905,2564,510,2428,442,4152,937,2140,530,2012,458,616,350,334,194,282,165,139,107,65,65,74,52,32,33,25,25,7,12,53,74,0,17,53,74
14000US08001009304,"Census Tract 93.04, Adams, CO",5604,714,2397,394,3207,649,4470,771,1869,372,2601,657,696,420,260,186,436,277,438,301,268,275,170,98,0,17,0,17,0,17,0,17,0,17,0,17
14000US08001009306,"Census Tract 93.06, Adams, CO",3102,419,1562,233,1540,230,2931,421,1445,241,1486,223,24,29,14,20,10,18,136,105,96,72,40,43,11,24,7,13,4,21,0,12,0,12,0,12
14000US08001009307,"Census Tract 93.07, Adams, CO",3217,641,1789,358,1428,338,3016,625,1656,339,1360,340,30,33,10,16,20,30,134,113,86,68,48,48,19,30,19,30,0,12,18,29,18,29,0,12
14000US08001009308,"Census Tract 93.08, Adams, CO",4806,689,2473,461,2333,420,3981,688,2029,424,1952,394,175,155,83,82,92,100,506,380,253,195,253,256,144,79,108,60,36,40,0,12,0,12,0,12
14000US08001009309,"Census Tract 93.09, Adams, CO",4230,619,2037,502,2193,297,3852,515,1872,438,1980,268,272,202,128,132,144,109,72,62,37,42,35,30,34,34,0,12,34,34,0,12,0,12,0,12
14000US08001009310,"Census Tract 93.10, Adams, CO",6633,1459,2980,452,3653,1123,5379,886,2600,328,2779,686,1052,1204,254,284,798,931,202,197,126,112,76,89,0,17,0,17,0,17,0,17,0,17,0,17
14000US08001009316,"Census Tract 93.16, Adams, CO",7619,1354,3681,737,3938,746,6455,1399,3207,732,3248,799,783,422,304,165,479,270,366,318,170,115,196,235,15,26,0,17,15,26,0,17,0,17,0,17
14000US08001009318,"Census Tract 93.18, Adams, CO",6678,1002,3265,640,3413,626,5649,980,2716,628,2933,581,761,446,421,223,340,295,209,148,69,62,140,124,59,85,59,85,0,17,0,17,0,17,0,17
14000US08001009319,"Census Tract 93.19, Adams, CO",2689,547,1488,358,1201,233,2442,562,1355,368,1087,236,138,73,69,47,69,39,77,53,46,42,31,23,32,31,18,28,14,15,0,12,0,12,0,12
14000US08001009320,"Census Tract 93.20, Adams, CO",2749,563,1391,386,1358,257,2353,582,1200,408,1153,258,266,151,141,111,125,77,78,60,22,25,56,42,52,51,28,44,24,26,0,12,0,12,0,12
14000US08001009321,"Census Tract 93.21, Adams, CO",4085,668,2058,510,2027,311,3358,686,1741,521,1617,274,288,255,94,74,194,218,307,197,154,95,153,126,126,97,69,48,57,60,6,9,0,12,6,9
14000US08001009322,"Census Tract 93.22, Adams, CO",5669,1153,3049,865,2620,462,5050,1139,2868,863,2182,389,482,363,124,81,358,308,101,97,44,71,57,65,36,45,13,21,23,26,0,17,0,17,0,17
14000US08001009323,"Census Tract 93.23, Adams, CO",3882,453,1880,285,2002,335,3247,476,1585,301,1662,323,473,209,222,106,251,123,69,57,36,34,33,40,64,52,37,31,27,33,29,52,0,12,29,52
14000US08001009325,"Census Tract 93.25, Adams, CO",5355,677,2579,397,2776,437,3899,630,2000,430,1899,294,612,368,296,204,316,226,544,246,199,99,345,194,300,192,84,61,216,163,0,17,0,17,0,17
14000US08001009326,"Census Tract 93.26, Adams, CO",2936,464,1436,273,1500,243,2577,477,1249,280,1328,244,151,145,61,81,90,93,105,64,68,42,37,35,103,71,58,46,45,37,0,12,0,12,0,12
14000US08001009327,"Census Tract 93.27, Adams, CO",4488,622,2609,410,1879,268,4171,641,2401,419,1770,279,122,105,78,80,44,43,183,156,125,109,58,58,5,12,5,12,0,12,7,11,0,12,7,11
14000US08001009401,"Census Tract 94.01, Adams, CO",5187,655,2707,392,2480,361,4699,627,2401,370,2298,363,147,87,76,55,71,58,263,109,171,83,92,54,47,46,47,46,0,17,31,48,12,18,19,31
14000US08001009406,"Census Tract 94.06, Adams, CO",4781,615,2233,273,2548,516,3706,578,1711,230,1995,477,311,211,155,146,156,79,550,202,238,109,312,135,164,126,110,97,54,44,50,49,19,35,31,38
14000US08001009407,"Census Tract 94.07, Adams, CO",5052,826,2593,410,2459,515,4157,758,2127,339,2030,507,240,130,84,63,156,88,579,260,306,154,273,153,0,17,0,17,0,17,76,117,76,117,0,17
14000US08001009408,"Census Tract 94.08, Adams, CO",4823,492,2372,372,2451,262,4266,493,2105,362,2161,261,208,118,94,83,114,50,228,142,100,67,128,86,121,110,73,79,48,51,0,12,0,12,0,12
14000US08001009409,"Census Tract 94.09, Adams, CO",5338,901,2416,330,2922,643,4405,428,2110,240,2295,270,121,92,73,58,48,53,679,820,194,221,485,605,133,123,39,44,94,85,0,17,0,17,0,17
14000US08001009410,"Census Tract 94.10, Adams, CO",3152,355,1721,257,1431,150,2861,414,1559,287,1302,166,113,94,51,39,62,62,73,64,23,26,50,44,98,88,81,83,17,21,7,11,7,11,0,12
14000US08001009411,"Census Tract 94.11, Adams, CO",3050,354,1715,235,1335,189,2577,376,1424,239,1153,199,267,132,168,88,99,54,95,58,58,41,37,29,111,110,65,72,46,45,0,12,0,12,0,12
14000US08001009501,"Census Tract 95.01, Adams, CO",2945,526,1569,330,1376,273,2618,536,1309,314,1309,277,117,151,117,151,0,12,104,63,55,37,49,45,106,68,88,61,18,29,0,12,0,12,0,12
14000US08001009502,"Census Tract 95.02, Adams, CO",4923,925,2583,531,2340,465,4478,898,2363,524,2115,455,141,93,98,81,43,36,230,130,96,60,134,82,74,61,26,28,48,38,0,17,0,17,0,17
14000US08001009553,"Census Tract 95.53, Adams, CO",3606,498,2230,477,1376,188,3004,621,1892,549,1112,192,411,273,199,145,212,136,111,144,59,65,52,83,0,12,0,12,0,12,80,100,80,100,0,12
14000US08001009603,"Census Tract 96.03, Adams, CO",6357,814,3206,543,3151,472,4397,701,2129,385,2268,515,438,400,309,289,129,118,1330,514,643,289,687,320,122,141,94,113,28,36,70,53,31,35,39,33
14000US08001009604,"Census Tract 96.04, Adams, CO",4050,400,1877,212,2173,288,3485,375,1567,190,1918,270,191,173,108,111,83,70,284,161,145,104,139,85,5,9,0,12,5,9,85,108,57,77,28,33
14000US08001009606,"Census Tract 96.06, Adams, CO",2706,597,1407,395,1299,347,2451,602,1294,409,1157,321,92,80,34,34,58,75,33,39,23,25,10,17,130,119,56,58,74,70,0,12,0,12,0,12
14000US08001009607,"Census Tract 96.07, Adams, CO",4422,510,2323,324,2099,284,3759,566,1888,354,1871,283,355,171,273,139,82,65,214,96,111,74,103,57,62,44,39,33,23,22,32,44,12,20,20,26
14000US08001009608,"Census Tract 96.08, Adams, CO",3053,67,1427,160,1626,140,2816,93,1319,143,1497,147,68,44,39,38,29,25,135,79,63,51,72,43,34,36,6,9,28,34,0,12,0,12,0,12
14000US08001009751,"Census Tract 97.51, Adams, CO",3990,703,1956,459,2034,383,3162,660,1589,425,1573,308,138,118,74,87,64,69,487,266,218,154,269,177,203,159,75,58,128,105,0,12,0,12,0,12
14000US08001009752,"Census Tract 97.52, Adams, CO",3145,611,1507,213,1638,478,2740,605,1317,219,1423,469,39,28,24,21,15,18,226,114,113,77,113,51,132,156,53,55,79,102,8,13,0,12,8,13
14000US08001015000,"Census Tract 150, Adams, CO",3025,468,1462,256,1563,283,2670,442,1254,244,1416,268,286,147,167,95,119,65,66,48,41,39,25,26,3,7,0,12,3,7,0,12,0,12,0,12
14000US08001060100,"Census Tract 601, Adams, CO",7418,703,3887,417,3531,447,6092,737,3010,406,3082,464,747,331,502,232,245,116,479,250,320,181,159,112,100,115,55,65,45,52,0,17,0,17,0,17
14000US08001060200,"Census Tract 602, Adams, CO",4656,498,2423,404,2233,264,3331,494,1705,354,1626,254,533,292,266,159,267,160,368,188,215,115,153,96,424,191,237,172,187,96,0,12,0,12,0,12
14000US08001061200,"Census Tract 612, Adams, CO",3004,365,1434,184,1570,218,2625,314,1254,173,1371,185,181,129,101,69,80,64,113,56,43,29,70,40,85,56,36,30,49,42,0,12,0,12,0,12
14000US08001988700,"Census Tract 9887, Adams, CO",0,12,0,12,0,12,0,12,0,12,0,12,0,12,0,12,0,12,0,12,0,12,0,12,0,12,0,12,0,12,0,12,0,12,0,12
14000US08003960000,"Census Tract 9600, Alamosa, CO",2111,327,1113,202,998,168,1906,320,1019,204,887,154,128,76,59,39,69,52,30,20,16,14,14,13,34,30,19,25,15,17,13,16,0,12,13,16
14000US08003960100,"Census Tract 9601, Alamosa, CO",2678,302,1199,209,1479,184,2418,329,1076,215,1342,202,104,106,68,69,36,41,59,40,36,27,23,18,83,62,10,10,73,57,14,15,9,14,5,10
14000US08003960300,"Census Tract 9603, Alamosa, CO",5225,512,2444,337,2781,279,4087,508,1927,303,2160,307,439,195,205,107,234,118,560,213,281,150,279,123,139,84,31,29,108,81,0,17,0,17,0,17
14000US08005004951,"Census Tract 49.51, Arapahoe, CO",1674,383,864,239,810,226,1103,250,539,140,564,173,84,49,69,44,15,17,160,70,81,51,79,61,327,343,175,187,152,178,0,12,0,12,0,12
14000US08005004952,"Census Tract 49.52, Arapahoe, CO",3485,380,1815,187,1670,329,2244,431,1119,181,1125,353,161,80,93,49,68,40,568,203,361,156,207,107,454,181,225,104,229,112,58,72,17,27,41,47
14000US08005005551,"Census Tract 55.51, Arapahoe, CO",2888,499,1540,276,1348,287,2636,498,1366,282,1270,277,83,70,69,61,14,23,62,48,57,47,5,12,107,122,48,48,59,84,0,12,0,12,0,12
14000US08005005552,"Census Tract 55.52, Arapahoe, CO",2416,353,1084,181,1332,310,2182,365,914,168,1268,312,11,18,11,18,0,12,197,86,151,70,46,57,26,29,8,12,18,25,0,12,0,12,0,12
14000US08005005553,"Census Tract 55.53, Arapahoe, CO",4503,681,2346,407,2157,371,4054,604,2102,383,1952,334,98,70,69,60,29,29,202,89,83,41,119,77,124,98,92,70,32,33,25,33,0,12,25,33
14000US08005005611,"Census Tract 56.11, Arapahoe, CO",5342,628,2698,333,2644,396,4389,552,2276,298,2113,335,474,368,259,218,215,180,276,120,114,63,162,80,104,69,41,44,63,41,99,130,8,18,91,128
14000US08005005612,"Census Tract 56.12, Arapahoe, CO",3456,399,1783,263,1673,268,3093,405,1539,257,1554,276,185,142,136,106,49,41,108,72,61,45,47,50,70,64,47,42,23,27,0,12,0,12,0,12
14000US08005005614,"Census Tract 56.14, Arapahoe, CO",3236,352,1599,220,1637,305,3046,393,1505,221,1541,338,141,127,62,49,79,80,24,37,15,24,9,13,25,38,17,25,8,13,0,12,0,12,0,12
14000US08005005619,"Census Tract 56.19, Arapahoe, CO",5089,769,2489,339,2600,466,4743,749,2308,333,2435,458,78,46,62,41,16,21,145,110,77,69,68,46,46,39,18,18,28,28,77,88,24,35,53,56
14000US08005005620,"Census Tract 56.20, Arapahoe, CO",2835,444,1166,281,1669,252,2199,446,920,287,1279,226,335,214,97,61,238,165,128,83,64,48,64,51,173,110,85,64,88,59,0,12,0,12,0,12
14000US08005005621,"Census Tract 56.21, Arapahoe, CO",2545,260,1238,152,1307,182,2371,256,1148,149,1223,182,44,44,27,26,17,25,64,63,48,50,16,18,45,53,5,10,40,44,21,32,10,15,11,18
14000US08005005622,"Census Tract 56.22, Arapahoe, CO",2768,310,1478,174,1290,170,2354,307,1265,172,1089,163,96,71,60,50,36,31,255,139,112,62,143,86,63,47,41,30,22,22,0,12,0,12,0,12
14000US08005005623,"Census Tract 56.23, Arapahoe, CO",3894,328,1898,200,1996,228,3190,296,1557,167,1633,197,218,150,153,121,65,50,271,107,123,70,148,80,215,156,65,63,150,124,0,12,0,12,0,12
14000US08005005624,"Census Tract 56.24, Arapahoe, CO",2345,281,1148,158,1197,155,2089,258,1022,129,1067,162,8,9,6,9,2,4,151,121,52,38,99,91,97,71,68,63,29,22,0,12,0,12,0,12
14000US08005005625,"Census Tract 56.25, Arapahoe, CO",3941,435,1942,295,1999,293,3106,356,1545,236,1561,224,306,214,111,103,195,124,340,209,139,80,201,160,189,164,147,150,42,37,0,12,0,12,0,12
14000US08005005626,"Census Tract 56.26, Arapahoe, CO",3889,591,1985,466,1904,217,3054,592,1601,439,1453,239,279,142,99,67,180,87,206,110,92,57,114,75,302,238,161,155,141,97,48,65,32,41,16,25
14000US08005005627,"Census Tract 56.27, Arapahoe, CO",4621,338,2166,218,2455,191,4148,375,1959,231,2189,210,163,93,52,40,111,63,241,149,115,80,126,82,45,43,28,28,17,22,24,35,12,17,12,18
14000US08005005628,"Census Tract 56.28, Arapahoe, CO",5857,722,2813,361,3044,479,5250,672,2464,326,2786,463,81,53,49,45,32,30,447,351,259,231,188,135,79,57,41,36,38,45,0,17,0,17,0,17
14000US08005005629,"Census Tract 56.29, Arapahoe, CO",2696,411,1328,180,1368,269,2435,417,1169,181,1266,273,77,44,42,27,35,26,67,73,38,39,29,35,117,69,79,50,38,26,0,12,0,12,0,12
14000US08005005630,"Census Tract 56.30, Arapahoe, CO",5331,518,2740,386,2591,267,4960,569,2539,396,2421,296,244,237,137,149,107,93,49,72,7,14,42,66,78,100,57,69,21,33,0,17,0,17,0,17
14000US08005005631,"Census Tract 56.31, Arapahoe, CO",3420,472,1591,273,1829,261,3196,467,1464,256,1732,267,52,70,31,37,21,34,157,119,89,81,68,44,15,24,7,12,8,12,0,12,0,12,0,12
14000US08005005632,"Census Tract 56.32, Arapahoe, CO",3036,269,1479,162,1557,181,2671,253,1288,155,1383,167,71,52,30,29,41,36,210,139,99,68,111,75,84,71,62,50,22,24,0,12,0,12,0,12
14000US08005005633,"Census Tract 56.33, Arapahoe, CO",3714,891,1745,377,1969,551,3474,898,1671,379,1803,553,84,64,9,12,75,62,88,50,38,30,50,38,68,71,27,34,41,46,0,12,0,12,0,12
14000US08005005634,"Census Tract 56.34, Arapahoe, CO",2846,261,1186,151,1660,182,2184,249,897,139,1287,175,224,131,90,63,134,78,269,123,128,66,141,70,158,106,60,50,98,64,11,17,11,17,0,12
14000US08005005635,"Census Tract 56.35, Arapahoe, CO",4712,383,2241,240,2471,265,4200,378,1998,235,2202,250,218,115,120,86,98,69,237,153,95,68,142,95,42,34,21,21,21,23,15,25,7,12,8,13
14000US08005005636,"Census Tract 56.36, Arapahoe, CO",1708,235,853,116,855,148,1596,234,785,107,811,151,42,47,21,23,21,24,27,34,21,26,6,9,43,47,26,27,17,26,0,12,0,12,0,12
14000US08005005800,"Census Tract 58, Arapahoe, CO",2666,396,1181,155,1485,315,2235,357,949,161,1286,288,182,148,92,81,90,77,206,94,123,58,83,54,43,41,17,19,26,29,0,12,0,12,0,12
14000US08005005951,"Census Tract 59.51, Arapahoe, CO",4672,574,1996,399,2676,504,3723,499,1645,359,2078,378,173,138,57,49,116,119,437,326,148,112,289,300,322,202,146,120,176,138,17,27,0,12,17,27
14000US08005005952,"Census Tract 59.52, Arapahoe, CO",3885,443,1935,314,1950,257,2114,302,994,166,1120,184,645,334,394,216,251,132,847,341,423,236,424,201,245,118,98,59,147,94,34,44,26,32,8,14
14000US08005006000,"Census Tract 60, Arapahoe, CO",2638,343,1347,175,1291,211,2233,361,1168,179,1065,216,174,136,70,61,104,82,155,71,97,58,58,44,66,66,12,18,54,51,10,17,0,12,10,17
14000US08005006100,"Census Tract 61, Arapahoe, CO",3477,523,1635,280,1842,305,2673,522,1241,288,1432,273,250,106,126,78,124,73,410,113,218,91,192,70,144,99,50,42,94,66,0,12,0,12,0,12
14000US08005006200,"Census Tract 62, Arapahoe, CO",3558,494,1608,216,1950,449,2795,410,1417,225,1378,261,273,279,59,59,214,226,425,392,82,59,343,397,65,58,50,48,15,25,0,12,0,12,0,12
14000US08005006300,"Census Tract 63, Arapahoe, CO",2589,353,1263,230,1326,214,2312,370,1078,224,1234,215,101,97,47,59,54,55,115,87,77,77,38,44,50,60,50,60,0,12,11,18,11,18,0,12
14000US08005006400,"Census Tract 64, Arapahoe, CO",3078,448,1456,256,1622,357,2241,342,1245,272,996,155,535,421,93,123,442,358,250,160,113,70,137,123,24,34,5,9,19,29,28,35,0,12,28,35
14000US08005006501,"Census Tract 65.01, Arapahoe, CO",2275,370,1302,228,973,215,1437,330,821,211,616,163,275,121,115,53,160,98,201,100,148,89,53,39,362,172,218,94,144,97,0,12,0,12,0,12
14000US08005006502,"Census Tract 65.02, Arapahoe, CO",3346,390,1803,302,1543,210,2732,378,1390,277,1342,212,214,133,132,90,82,62,164,89,89,70,75,49,236,144,192,132,44,31,0,12,0,12,0,12
14000US08005006601,"Census Tract 66.01, Arapahoe, CO",5577,767,2941,597,2636,494,4082,751,2122,528,1960,482,530,243,363,179,167,106,725,314,401,216,324,174,240,134,55,55,185,98,0,17,0,17,0,17
14000US08005006603,"Census Tract 66.03, Arapahoe, CO",2788,219,1359,177,1429,167,2328,252,1110,172,1218,164,184,118,126,88,58,49,86,63,51,40,35,28,190,141,72,51,118,91,0,12,0,12,0,12
14000US08005006604,"Census Tract 66.04, Arapahoe, CO",4349,731,1939,408,2410,432,3408,778,1528,391,1880,444,413,261,133,83,280,226,375,201,197,128,178,97,63,45,44,36,19,20,90,63,37,37,53,70
14000US08005006704,"Census Tract 67.04, Arapahoe, CO",4527,242,2284,186,2243,164,4013,314,2034,205,1979,188,110,110,59,61,51,49,245,147,133,85,112,79,136,150,35,36,101,124,23,26,23,26,0,12
14000US08005006705,"Census Tract 67.05, Arapahoe, CO",2138,243,1025,141,1113,152,1861,288,913,153,948,161,177,172,55,54,122,125,76,78,45,55,31,31,24,37,12,19,12,18,0,12,0,12,0,12
14000US08005006706,"Census Tract 67.06, Arapahoe, CO",5691,632,2525,307,3166,433,4420,664,1861,303,2559,436,546,275,268,151,278,163,219,130,129,79,90,62,363,190,212,106,151,103,143,173,55,82,88,93
14000US08005006707,"Census Tract 67.07, Arapahoe, CO",5009,386,2697,300,2312,266,4358,384,2410,266,1948,234,104,94,50,47,54,68,284,168,164,144,120,72,216,200,59,62,157,144,47,52,14,21,33,47
14000US08005006708,"Census Tract 67.08, Arapahoe, CO",5064,557,2545,439,2519,235,4256,511,2045,333,2211,245,409,286,294,256,115,68,167,121,116,92,51,43,151,124,75,61,76,75,81,95,15,23,66,73
14000US08005006709,"Census Tract 67.09, Arapahoe, CO",5232,686,2738,432,2494,322,4646,653,2417,440,2229,294,27,31,14,24,13,21,513,336,293,196,220,162,46,58,14,22,32,52,0,17,0,17,0,17
14000US08005006711,"Census Tract 67.11, Arapahoe, CO",4258,683,2137,332,2121,405,3952,690,1978,327,1974,403,156,123,110,87,46,42,102,75,25,30,77,56,48,40,24,29,24,28,0,12,0,12,0,12
14000US08005006712,"Census Tract 67.12, Arapahoe, CO",1202,237,624,165,578,87,898,243,478,169,420,87,64,46,41,26,23,23,166,66,80,35,86,39,51,39,20,20,31,28,23,28,5,7,18,22
14000US08005006713,"Census Tract 67.13, Arapahoe, CO",1780,261,1006,197,774,136,1064,277,607,200,457,141,112,41,71,26,41,26,205,106,116,68,89,56,240,104,115,59,125,53,159,87,97,71,62,38
14000US08005006808,"Census Tract 68.08, Arapahoe, CO",5481,514,2678,381,2803,243,4792,555,2349,413,2443,239,225,174,93,67,132,108,268,155,149,89,119,69,196,168,87,71,109,100,0,17,0,17,0,17
14000US08005006815,"Census Tract 68.15, Arapahoe, CO",4735,542,2117,290,2618,452,3706,548,1671,275,2035,440,407,209,197,109,210,129,302,150,73,50,229,116,292,176,176,112,116,83,28,23,0,12,28,23
14000US08005006854,"Census Tract 68.54, Arapahoe, CO",2877,281,1329,186,1548,204,2261,331,1009,186,1252,229,142,98,45,31,97,92,191,92,102,64,89,65,200,125,104,78,96,56,83,90,69,80,14,24
14000US08005006857,"Census Tract 68.57, Arapahoe, CO",2134,244,1083,170,1051,110,1885,243,979,162,906,119,16,20,10,16,6,10,89,68,41,39,48,34,98,75,25,24,73,60,46,51,28,31,18,26
14000US08005007101,"Census Tract 71.01, Arapahoe, CO",5929,877,2817,351,3112,612,5568,900,2685,361,2883,623,64,56,21,24,43,41,248,112,81,51,167,79,48,59,30,44,18,17,1,5,0,17,1,5
14000US08005007103,"Census Tract 71.03, Arapahoe, CO",1597,203,791,106,806,127,1353,191,688,99,665,119,55,39,26,18,29,28,181,129,69,49,112,88,8,14,8,14,0,12,0,12,0,12,0,12
14000US08005007106,"Census Tract 71.06, Arapahoe, CO",6411,1088,3015,621,3396,505,5941,1084,2747,606,3194,512,159,167,91,115,68,70,108,71,87,65,21,24,99,83,76,57,23,38,104,84,14,22,90,81
14000US08005007201,"Census Tract 72.01, Arapahoe, CO",3729,546,1882,291,1847,357,2366,417,1227,245,1139,238,565,297,295,155,270,173,457,200,233,126,224,125,162,97,64,57,98,76,179,141,63,52,116,104
14000US08005007202,"Census Tract 72.02, Arapahoe, CO",4458,907,2310,482,2148,550,3773,922,1766,414,2007,568,337,289,276,236,61,62,237,140,164,129,73,68,35,41,28,39,7,10,76,58,76,58,0,12
14000US08005007301,"Census Tract 73.01, Arapahoe, CO",2500,344,1336,211,1164,203,1729,331,909,193,820,182,353,148,174,89,179,77,224,99,151,80,73,44,148,73,81,45,67,52,46,50,21,26,25,25
14000US08005007302,"Census Tract 73.02, Arapahoe, CO",5117,694,2737,427,2380,430,3767,577,1934,324,1833,372,468,286,329,226,139,114,682,376,316,156,366,255,112,86,103,82,9,15,88,92,55,83,33,39
14000US08005007400,"Census Tract 74, Arapahoe, CO",5326,654,2672,341,2654,425,4167,578,2158,320,2009,345,687,387,339,203,348,219,423,303,161,130,262,226,46,56,11,17,35,53,3,11,3,11,0,17
14000US08005007500,"Census Tract 75, Arapahoe, CO",2564,414,1182,230,1382,245,2188,445,997,246,1191,253,114,75,70,62,44,27,135,165,60,80,75,87,115,96,48,47,67,57,12,20,7,13,5,7
14000US08005007600,"Census Tract 76, Arapahoe, CO",3557,596,1699,322,1858,367,3050,552,1507,291,1543,338,222,187,133,111,89,90,270,175,51,41,219,155,15,16,8,12,7,11,0,12,0,12,0,12
14000US08005007702,"Census Tract 77.02, Arapahoe, CO",3784,412,2153,281,1631,243,3255,403,1815,232,1440,261,156,84,117,75,39,35,301,225,157,132,144,108,72,50,64,46,8,12,0,12,0,12,0,12
14000US08005007703,"Census Tract 77.03, Arapahoe, CO",5139,963,2763,715,2376,422,3959,819,2157,590,1802,384,737,541,422,290,315,275,314,184,120,100,194,105,129,89,64,53,65,48,0,17,0,17,0,17
14000US08005007704,"Census Tract 77.04, Arapahoe, CO",5466,724,2754,480,2712,416,4268,701,1973,372,2295,428,540,328,385,312,155,95,531,233,335,151,196,100,127,94,61,50,66,56,0,17,0,17,0,17
14000US08005015100,"Census Tract 151, Arapahoe, CO",2739,315,1181,184,1558,217,2479,318,1094,187,1385,200,114,83,47,44,67,49,77,76,9,14,68,72,69,74,31,35,38,45,0,12,0,12,0,12
14000US08005080000,"Census Tract 800, Arapahoe, CO",4228,594,1988,492,2240,292,3308,562,1612,441,1696,237,54,38,25,37,29,37,691,345,272,263,419,236,175,94,79,54,96,62,0,12,0,12,0,12
14000US08005080100,"Census Tract 801, Arapahoe, CO",4125,663,2019,451,2106,344,3285,537,1533,366,1752,274,269,143,153,115,116,74,501,300,299,173,202,166,70,55,34,37,36,30,0,12,0,12,0,12
14000US08005080200,"Census Tract 802, Arapahoe, CO",6691,722,3292,381,3399,465,5009,552,2482,294,2527,346,784,335,377,192,407,191,382,211,192,126,190,121,492,537,224,244,268,297,24,27,17,19,7,11
14000US08005080300,"Census Tract 803, Arapahoe, CO",5941,809,3026,564,2915,404,4852,787,2428,554,2424,382,914,537,492,292,422,262,130,91,78,71,52,42,45,141,28,110,17,34,0,17,0,17,0,17
14000US08005080400,"Census Tract 804, Arapahoe, CO",4901,548,2452,308,2449,370,4260,547,2133,307,2127,368,430,228,250,126,180,115,91,59,25,28,66,49,101,92,44,40,57,57,19,27,0,12,19,27
14000US08005080500,"Census Tract 805, Arapahoe, CO",3603,479,1558,223,2045,392,3126,501,1318,236,1808,386,211,156,84,70,127,100,175,100,86,52,89,74,91,80,70,56,21,33,0,12,0,12,0,12
14000US08005080600,"Census Tract 806, Arapahoe, CO",3475,624,1447,317,2028,415,2649,525,1126,298,1523,300,293,162,138,99,155,99,288,213,97,82,191,146,245,159,86,54,159,126,0,12,0,12,0,12
14000US08005080700,"Census Tract 807, Arapahoe, CO",5724,817,2955,569,2769,377,4805,808,2538,560,2267,349,418,187,192,104,226,164,302,187,133,106,169,101,147,199,82,104,65,96,52,52,10,16,42,43
14000US08005080800,"Census Tract 808, Arapahoe, CO",3494,407,1700,256,1794,258,2652,559,1252,314,1400,305,611,307,320,137,291,197,150,92,78,48,72,67,80,65,50,41,30,30,1,2,0,12,1,2
14000US08005080900,"Census Tract 809, Arapahoe, CO",4872,898,2720,823,2152,265,3722,786,1956,564,1766,338,176,114,51,43,125,90,764,673,587,560,177,206,176,146,117,136,59,57,34,132,9,35,25,96
14000US08005081200,"Census Tract 812, Arapahoe, CO",5163,846,2760,542,2403,389,4059,806,2234,535,1825,342,621,378,303,212,318,206,441,235,195,150,246,122,35,41,28,39,7,12,7,11,0,17,7,11
14000US08005081300,"Census Tract 813, Arapahoe, CO",3026,499,1537,254,1489,306,2634,497,1365,260,1269,296,305,193,130,86,175,125,32,37,10,14,22,31,55,67,32,36,23,33,0,12,0,12,0,12
14000US08005081400,"Census Tract 814, Arapahoe, CO",4163,535,2032,319,2131,304,3728,523,1853,299,1875,303,109,77,9,12,100,74,213,112,106,86,107,68,113,69,64,42,49,46,0,12,0,12,0,12
14000US08005081500,"Census Tract 815, Arapahoe, CO",2915,274,884,158,2031,231,2564,258,840,153,1724,205,144,104,12,18,132,98,117,70,32,36,85,59,15,23,0,12,15,23,75,122,0,12,75,122
14000US08005081600,"Census Tract 816, Arapahoe, CO",5155,814,2451,373,2704,552,4411,808,2023,340,2388,562,349,172,248,157,101,68,351,258,170,158,181,110,21,34,10,17,11,18,23,35,0,17,23,35
14000US08005081700,"Census Tract 817, Arapahoe, CO",2928,300,1440,167,1488,173,2822,305,1379,166,1443,175,75,66,58,49,17,18,31,37,3,5,28,36,0,12,0,12,0,12,0,12,0,12,0,12
14000US08005081800,"Census Tract 818, Arapahoe, CO",5361,656,2528,450,2833,352,5001,715,2321,468,2680,378,177,137,105,74,72,70,179,144,102,85,77,68,4,9,0,17,4,9,0,17,0,17,0,17
14000US08005081900,"Census Tract 819, Arapahoe, CO",6681,1141,3502,584,3179,690,5643,1059,2984,572,2659,621,188,175,175,173,13,23,638,474,280,190,358,295,174,161,25,30,149,148,38,47,38,47,0,17
14000US08005082000,"Census Tract 820, Arapahoe, CO",4878,835,2506,555,2372,461,3409,844,1657,480,1752,508,604,503,347,317,257,205,535,205,310,148,225,128,330,209,192,128,138,112,0,12,0,12,0,12
14000US08005082100,"Census Tract 821, Arapahoe, CO",6979,1029,3511,647,3468,590,5413,937,2823,638,2590,491,728,437,265,144,463,320,708,500,372,228,336,324,130,105,51,59,79,77,0,17,0,17,0,17
14000US08005082200,"Census Tract 822, Arapahoe, CO",6408,1038,3351,664,3057,628,5494,929,2820,508,2674,592,586,348,267,203,319,245,152,152,109,125,43,72,164,241,155,240,9,21,12,27,0,17,12,27
14000US08005082300,"Census Tract 823, Arapahoe, CO",4428,899,2068,313,2360,690,3646,966,1610,362,2036,713,400,252,258,175,142,86,300,282,184,224,116,99,54,45,16,24,38,38,28,42,0,12,28,42
14000US08005082400,"Census Tract 824, Arapahoe, CO",4432,866,2240,531,2192,419,3560,805,1835,507,1725,374,392,224,139,94,253,153,91,72,33,31,58,48,261,215,140,130,121,95,128,201,93,147,35,53
14000US08005082500,"Census Tract 825, Arapahoe, CO",2358,293,1160,175,1198,163,1956,299,979,169,977,168,322,211,152,108,170,113,40,29,23,19,17,17,40,40,6,9,34,33,0,12,0,12,0,12
14000US08005082600,"Census Tract 826, Arapahoe, CO",5406,894,2777,515,2629,449,4139,800,2201,439,1938,434,489,330,156,126,333,219,468,435,273,238,195,213,295,236,140,123,155,116,15,36,7,18,8,19
14000US08005082700,"Census Tract 827, Arapahoe, CO",3512,504,1833,335,1679,270,2896,486,1503,332,1393,271,426,232,219,130,207,111,140,124,78,59,62,71,40,44,33,38,7,10,10,16,0,12,10,16
14000US08005082800,"Census Tract 828, Arapahoe, CO",5343,1046,2637,488,2706,627,4839,903,2475,490,2364,488,395,215,120,75,275,194,78,58,21,23,57,48,31,38,21,24,10,18,0,17,0,17,0,17
14000US08005082900,"Census Tract 829, Arapahoe, CO",5028,727,2394,342,2634,446,4851,737,2350,349,2501,448,149,104,24,24,125,87,22,26,14,22,8,14,6,10,6,10,0,17,0,17,0,17,0,17
14000US08005083000,"Census Tract 830, Arapahoe, CO",3756,538,1881,256,1875,344,3195,492,1583,232,1612,340,130,109,71,60,59,53,272,214,142,117,130,120,159,119,85,60,74,61,0,12,0,12,0,12
14000US08005083100,"Census Tract 831, Arapahoe, CO",7233,834,3151,460,4082,559,5837,978,2630,499,3207,620,866,518,299,191,567,362,395,207,154,103,241,156,135,121,68,82,67,69,0,17,0,17,0,17
14000US08005083300,"Census Tract 833, Arapahoe, CO",4481,465,2388,367,2093,277,3726,463,1960,338,1766,236,383,217,258,171,125,77,282,145,114,81,168,114,90,62,56,46,34,31,0,12,0,12,0,12
14000US08005083400,"Census Tract 834, Arapahoe, CO",7018,1075,3438,486,3580,667,6495,1062,3118,482,3377,655,168,116,84,65,84,94,240,157,137,87,103,91,115,84,99,72,16,24,0,17,0,17,0,17
14000US08005083500,"Census Tract 835, Arapahoe, CO",6394,837,3372,576,3022,373,4891,570,2481,341,2410,338,1087,662,684,510,403,193,207,151,95,109,112,71,196,161,112,123,84,51,13,24,0,17,13,24
14000US08005083600,"Census Tract 836, Arapahoe, CO",3824,543,1853,342,1971,302,2828,454,1436,319,1392,228,563,259,234,136,329,151,270,213,118,98,152,123,163,117,65,45,98,109,0,12,0,12,0,12
14000US08005083700,"Census Tract 837, Arapahoe, CO",3797,526,1520,197,2277,405,3108,531,1289,221,1819,374,431,239,140,93,291,165,60,53,27,31,33,32,155,93,64,46,91,82,43,48,0,12,43,48
14000US08005083800,"Census Tract 838, Arapahoe, CO",2967,502,1446,338,1521,243,2515,485,1201,289,1314,249,268,196,154,157,114,82,94,68,36,39,58,55,61,62,38,34,23,35,29,37,17,19,12,22
14000US08005083900,"Census Tract 839, Arapahoe, CO",3049,413,1490,188,1559,311,2453,400,1189,197,1264,288,242,150,134,89,108,75,212,139,88,68,124,113,142,91,79,58,63,56,0,12,0,12,0,12
14000US08005084000,"Census Tract 840, Arapahoe, CO",2814,400,1515,243,1299,197,2602,403,1381,239,1221,195,79,63,34,32,45,40,46,35,13,13,33,27,65,55,65,55,0,12,22,32,22,32,0,12
14000US08005084100,"Census Tract 841, Arapahoe, CO",4135,430,2100,299,2035,221,3659,441,1832,296,1827,222,312,125,189,99,123,77,84,75,61,65,23,30,80,62,18,23,62,47,0,12,0,12,0,12
14000US08005084200,"Census Tract 842, Arapahoe, CO",4055,587,1932,279,2123,361,3680,693,1758,323,1922,415,285,255,139,129,146,131,41,36,17,21,24,23,49,45,18,22,31,27,0,12,0,12,0,12
14000US08005084300,"Census Tract 843, Arapahoe, CO",3902,604,1820,289,2082,432,3482,570,1601,261,1881,424,133,99,63,46,70,62,249,232,148,129,101,107,38,38,8,14,30,29,0,12,0,12,0,12
14000US08005084400,"Census Tract 844, Arapahoe, CO",3367,544,1536,207,1831,430,3187,556,1420,201,1767,434,91,67,77,55,14,20,73,101,39,67,34,39,16,22,0,12,16,22,0,12,0,12,0,12
14000US08005084500,"Census Tract 845, Arapahoe, CO",2787,462,1456,274,1331,254,2326,466,1157,267,1169,254,249,106,170,80,79,52,164,108,110,72,54,44,48,49,19,23,29,32,0,12,0,12,0,12
14000US08005084600,"Census Tract 846, Arapahoe, CO",5476,521,2799,311,2677,293,4785,442,2478,277,2307,233,260,114,189,97,71,39,197,169,64,78,133,129,172,121,47,45,125,88,62,72,21,34,41,42
14000US08005084700,"Census Tract 847, Arapahoe, CO",4354,482,2154,331,2200,233,3967,505,2005,329,1962,265,245,119,83,49,162,85,90,58,49,40,41,29,44,43,9,15,35,36,8,13,8,13,0,12
14000US08005084800,"Census Tract 848, Arapahoe, CO",3509,544,1759,289,1750,327,3126,565,1527,297,1599,331,218,210,113,107,105,104,9,14,0,12,9,14,156,162,119,120,37,45,0,12,0,12,0,12
14000US08005084900,"Census Tract 849, Arapahoe, CO",3340,376,1709,216,1631,202,2952,387,1525,232,1427,178,75,67,38,35,37,33,126,89,75,57,51,45,109,132,71,99,38,38,78,92,0,12,78,92
14000US08005085000,"Census Tract 850, Arapahoe, CO",2471,294,1258,207,1213,152,1935,293,1011,197,924,147,199,112,107,76,92,53,167,103,54,40,113,75,158,128,80,73,78,57,12,15,6,11,6,10
14000US08005085100,"Census Tract 851, Arapahoe, CO",6533,741,3265,449,3268,373,5991,737,3007,457,2984,359,235,149,127,99,108,69,76,59,38,32,38,35,213,199,75,81,138,123,18,27,18,27,0,17
14000US08005085200,"Census Tract 852, Arapahoe, CO",3190,368,1565,235,1625,217,2752,405,1393,248,1359,219,171,103,57,38,114,93,63,45,32,24,31,28,175,137,76,70,99,69,29,34,7,11,22,24
14000US08005085300,"Census Tract 853, Arapahoe, CO",2453,277,1172,155,1281,191,2104,294,962,148,1142,196,170,107,128,78,42,37,35,29,15,18,20,14,144,86,67,51,77,41,0,12,0,12,0,12
14000US08005085400,"Census Tract 854, Arapahoe, CO",5079,972,2438,441,2641,578,4404,966,2111,433,2293,572,382,242,201,107,181,152,110,89,44,40,66,55,121,95,70,68,51,43,62,51,12,19,50,46
14000US08005085500,"Census Tract 855, Arapahoe, CO",5512,507,2868,298,2644,274,4823,536,2545,310,2278,290,375,203,210,108,165,102,156,76,43,29,113,58,139,101,61,55,78,64,19,21,9,14,10,16
14000US08005085600,"Census Tract 856, Arapahoe, CO",3441,459,1750,320,1691,188,3219,462,1641,318,1578,194,170,92,97,54,73,47,0,12,0,12,0,12,44,32,12,13,32,24,8,13,0,12,8,13
14000US08005085700,"Census Tract 857, Arapahoe, CO",4687,911,2667,636,2020,349,4182,861,2456,598,1726,333,152,124,26,32,126,113,213,201,98,95,115,112,118,111,78,83,40,41,22,34,9,14,13,20
14000US08005085800,"Census Tract 858, Arapahoe, CO",1731,213,894,150,837,130,1421,224,745,152,676,118,233,116,102,59,131,84,45,32,28,22,17,15,32,25,19,20,13,17,0,12,0,12,0,12
14000US08005085900,"Census Tract 859, Arapahoe, CO",6674,692,3287,384,3387,440,5547,733,2646,367,2901,472,637,245,353,133,284,135,366,282,228,186,138,101,108,90,60,49,48,47,16,23,0,17,16,23
14000US08005086100,"Census Tract 861, Arapahoe, CO",4607,529,2323,326,2284,283,4204,559,2104,325,2100,298,181,156,79,55,102,108,61,56,32,26,29,36,161,139,108,112,53,41,0,12,0,12,0,12
14000US08005086200,"Census Tract 862, Arapahoe, CO",6447,559,3178,328,3269,318,5677,579,2840,332,2837,316,379,170,164,77,215,104,137,122,28,29,109,115,214,168,106,86,108,90,40,37,40,37,0,17
14000US08005086300,"Census Tract 863, Arapahoe, CO",4621,529,2519,340,2102,266,3501,411,1866,254,1635,209,628,370,343,230,285,166,235,136,101,69,134,74,256,125,208,110,48,35,1,3,1,3,0,12
14000US08005086400,"Census Tract 864, Arapahoe, CO",1960,248,1059,191,901,96,1820,268,996,197,824,99,69,50,40,33,29,23,38,35,11,11,27,25,27,22,12,13,15,14,6,9,0,12,6,9
14000US08005086500,"Census Tract 865, Arapahoe, CO",5136,617,2469,378,2667,378,3917,519,1787,242,2130,350,869,523,477,362,392,204,152,93,92,67,60,48,186,101,101,69,85,61,12,18,12,18,0,17
14000US08005086600,"Census Tract 866, Arapahoe, CO",6029,627,2831,388,3198,351,4684,548,2182,267,2502,339,911,464,473,320,438,186,144,135,67,60,77,78,277,206,96,68,181,190,13,20,13,20,0,17
14000US08005086700,"Census Tract 867, Arapahoe, CO",6078,803,3203,505,2875,368,5323,784,2790,482,2533,363,333,168,169,89,164,85,132,108,86,77,46,36,279,168,147,106,132,81,11,17,11,17,0,17
14000US08005086900,"Census Tract 869, Arapahoe, CO",3031,491,1462,245,1569,351,1515,283,787,177,728,156,521,279,252,129,269,193,756,378,295,159,461,271,136,79,75,50,61,54,103,159,53,82,50,77
14000US08005087000,"Census Tract 870, Arapahoe, CO",5113,883,2452,533,2661,600,3575,892,1583,377,1992,614,763,469,498,411,265,194,283,159,142,98,141,81,407,281,204,137,203,179,85,101,25,37,60,66
14000US08005087100,"Census Tract 871, Arapahoe, CO",2637,336,1010,189,1627,254,1635,364,640,188,995,247,566,269,214,119,352,177,369,156,150,88,219,101,67,66,6,18,61,58,0,12,0,12,0,12
14000US08005087200,"Census Tract 872, Arapahoe, CO",3833,735,1882,433,1951,433,2640,636,1242,331,1398,418,230,114,172,106,58,62,354,235,218,158,136,109,574,460,250,258,324,215,35,56,0,12,35,56
14000US08007940400,"Census Tract 9404, Archuleta, CO",1514,314,786,178,728,185,1451,304,739,168,712,184,12,14,12,14,0,12,37,34,25,27,12,12,10,14,6,7,4,7,4,6,4,6,0,12
14000US08007974300,"Census Tract 9743, Archuleta, CO",3621,493,1928,299,1693,249,3409,493,1798,308,1611,239,62,56,42,40,20,19,62,52,44,40,18,32,71,78,27,36,44,47,17,24,17,24,0,12
14000US08007974400,"Census Tract 9744, Archuleta, CO",2585,349,1338,204,1247,198,2400,338,1256,198,1144,195,43,61,28,38,15,26,41,37,20,29,21,25,101,57,34,23,67,40,0,12,0,12,0,12
14000US08009964600,"Census Tract 9646, Baca, CO",1596,136,746,80,850,83,1428,123,666,73,762,80,67,67,32,31,35,38,57,26,29,19,28,18,30,31,17,22,13,13,14,19,2,3,12,18
14000US08009964700,"Census Tract 9647, Baca, CO",1945,141,1032,90,913,84,1704,158,886,108,818,84,140,70,83,42,57,38,35,28,25,24,10,10,66,37,38,23,28,18,0,12,0,12,0,12
14000US08013012101,"Census Tract 121.01, Boulder, CO",4909,638,2629,436,2280,378,4492,614,2365,420,2127,356,147,112,66,63,81,68,229,248,178,171,51,81,41,52,20,26,21,27,0,12,0,12,0,12
14000US08013012103,"Census Tract 121.03, Boulder, CO",3837,359,1843,242,1994,213,3326,370,1618,243,1708,214,287,121,145,69,142,64,66,50,30,26,36,29,158,106,50,39,108,71,0,12,0,12,0,12
14000US08013012104,"Census Tract 121.04, Boulder, CO",2319,251,1036,145,1283,172,2084,249,920,135,1164,171,110,103,40,45,70,71,0,12,0,12,0,12,43,59,26,33,17,27,82,66,50,47,32,28
14000US08013012105,"Census Tract 121.05, Boulder, CO",6017,757,3043,480,2974,395,4664,776,2375,469,2289,405,784,410,408,227,376,208,344,265,187,143,157,139,225,147,73,63,152,118,0,17,0,17,0,17
14000US08013012201,"Census Tract 122.01, Boulder, CO",3925,590,1796,288,2129,502,2355,514,1007,171,1348,399,885,235,428,168,457,228,373,126,157,84,216,100,305,109,201,101,104,69,7,12,3,6,4,6
14000US08013012204,"Census Tract 122.04, Boulder, CO",4327,662,2521,567,1806,377,2088,366,1213,319,875,178,1420,467,781,402,639,274,279,140,183,113,96,84,410,160,245,108,165,90,130,127,99,119,31,33
14000US08013012300,"Census Tract 123, Boulder, CO",6708,458,3723,296,2985,283,1650,237,866,135,784,172,658,140,383,92,275,99,1860,250,1021,169,839,174,1969,328,1079,214,890,211,571,166,374,114,197,92
14000US08013012401,"Census Tract 124.01, Boulder, CO",5852,902,2574,585,3278,860,2413,607,1257,463,1156,303,2335,642,958,352,1377,610,556,268,192,155,364,213,486,213,140,105,346,187,62,50,27,36,35,31
14000US08013012501,"Census Tract 125.01, Boulder, CO",2741,483,1466,245,1275,332,2262,452,1227,202,1035,327,158,83,85,62,73,57,114,147,52,69,62,85,194,87,89,57,105,64,13,20,13,20,0,12
14000US08013012505,"Census Tract 125.05, Boulder, CO",4164,436,2175,200,1989,311,3258,461,1664,191,1594,328,559,244,289,123,270,138,84,72,84,72,0,12,190,91,104,56,86,67,73,73,34,33,39,44
14000US08013012507,"Census Tract 125.07, Boulder, CO",4266,431,2363,355,1903,321,2629,391,1324,242,1305,266,973,293,619,254,354,182,345,120,206,97,139,93,218,109,129,72,89,61,101,78,85,73,16,25
14000US08013012508,"Census Tract 125.08, Boulder, CO",2726,287,1364,154,1362,237,2060,265,1017,140,1043,193,333,128,180,88,153,80,59,48,20,21,39,42,236,99,123,60,113,57,38,48,24,27,14,23
14000US08013012509,"Census Tract 125.09, Boulder, CO",3566,442,1738,314,1828,224,3086,470,1568,324,1518,221,358,213,127,98,231,141,63,64,26,28,37,40,15,22,7,8,8,15,44,68,10,16,34,65
14000US08013012510,"Census Tract 125.10, Boulder, CO",3990,388,1947,187,2043,278,3334,328,1610,184,1724,226,253,147,160,103,93,56,52,43,24,25,28,29,325,220,144,81,181,165,26,40,9,14,17,26
14000US08013012511,"Census Tract 125.11, Boulder, CO",6615,591,3480,287,3135,503,4340,567,2170,244,2170,467,816,239,515,173,301,124,686,154,420,120,266,86,568,174,300,118,268,105,205,79,75,31,130,70
14000US08013012603,"Census Tract 126.03, Boulder, CO",3461,467,1856,331,1605,233,2837,468,1542,321,1295,209,315,117,165,78,150,76,48,45,31,36,17,23,145,88,72,50,73,49,116,90,46,38,70,54
14000US08013012605,"Census Tract 126.05, Boulder, CO",1804,371,1101,312,703,217,879,160,524,156,355,123,471,232,220,115,251,148,252,180,230,186,22,27,147,95,104,82,43,59,55,40,23,18,32,25
14000US08013012608,"Census Tract 126.08, Boulder, CO",2584,293,1330,185,1254,179,1742,262,867,165,875,148,563,160,349,100,214,85,62,36,4,6,58,35,211,91,110,45,101,69,6,9,0,12,6,9
14000US08013012701,"Census Tract 127.01, Boulder, CO",5864,531,2604,307,3260,346,5015,538,2177,331,2838,331,507,280,280,167,227,135,125,112,61,70,64,59,217,146,86,73,131,89,0,17,0,17,0,17
14000US08013012705,"Census Tract 127.05, Boulder, CO",5491,841,2635,365,2856,577,4109,858,1852,378,2257,573,619,168,383,111,236,100,168,101,52,32,116,88,586,186,348,130,238,99,9,15,0,17,9,15
14000US08013012707,"Census Tract 127.07, Boulder, CO",2513,428,1374,270,1139,310,1809,392,834,166,975,319,380,171,283,124,97,68,171,112,120,79,51,62,105,68,89,58,16,16,48,56,48,56,0,12
14000US08013012708,"Census Tract 127.08, Boulder, CO",4530,441,2412,360,2118,188,3632,390,1856,277,1776,209,279,141,170,102,109,70,98,87,75,76,23,27,447,255,237,187,210,97,74,92,74,92,0,12
14000US08013012709,"Census Tract 127.09, Boulder, CO",2093,383,1128,266,965,152,1841,277,1007,256,834,108,108,90,91,87,17,17,113,131,4,7,109,130,31,31,26,25,5,9,0,12,0,12,0,12
14000US08013012710,"Census Tract 127.10, Boulder, CO",3536,263,1703,162,1833,221,3175,326,1587,183,1588,215,99,86,10,16,89,84,51,55,23,26,28,30,211,136,83,52,128,102,0,12,0,12,0,12
14000US08013012903,"Census Tract 129.03, Boulder, CO",2465,339,1274,268,1191,148,2225,347,1181,274,1044,148,113,81,55,43,58,45,64,42,21,22,43,28,33,29,17,16,16,17,30,31,0,12,30,31
14000US08013012904,"Census Tract 129.04, Boulder, CO",5729,558,2764,327,2965,406,4883,547,2282,300,2601,383,527,236,284,167,243,173,131,86,90,61,41,47,188,137,108,99,80,62,0,17,0,17,0,17
14000US08013012905,"Census Tract 129.05, Boulder, CO",2660,352,1318,248,1342,228,2007,316,1018,244,989,154,389,210,151,70,238,192,173,98,113,81,60,39,82,70,36,34,46,39,9,15,0,12,9,15
14000US08013012907,"Census Tract 129.07, Boulder, CO",3245,359,1628,260,1617,168,2734,317,1360,210,1374,159,221,124,92,64,129,67,148,100,129,98,19,19,128,82,40,38,88,65,14,22,7,10,7,11
14000US08013013003,"Census Tract 130.03, Boulder, CO",7093,571,3574,357,3519,304,5852,604,2936,366,2916,313,531,312,303,176,228,151,206,123,102,65,104,67,447,228,233,145,214,118,57,53,0,17,57,53
14000US08013013004,"Census Tract 130.04, Boulder, CO",3036,349,1396,181,1640,254,2800,351,1272,190,1528,237,170,104,112,78,58,47,15,19,12,18,3,5,51,68,0,12,51,68,0,12,0,12,0,12
14000US08013013005,"Census Tract 130.05, Boulder, CO",2612,242,1344,135,1268,160,2094,245,1076,139,1018,156,261,113,117,67,144,58,112,92,71,62,41,43,90,57,59,39,31,30,55,61,21,24,34,38
14000US08013013006,"Census Tract 130.06, Boulder, CO",5745,640,2981,451,2764,306,4850,590,2477,415,2373,279,298,151,155,106,143,75,130,99,37,43,93,61,446,432,291,279,155,157,21,27,21,27,0,17
14000US08013013201,"Census Tract 132.01, Boulder, CO",1916,209,939,124,977,123,1564,212,773,113,791,124,94,79,33,40,61,49,210,111,100,59,110,58,48,38,33,30,15,24,0,12,0,12,0,12
14000US08013013202,"Census Tract 132.02, Boulder, CO",1510,246,762,184,748,115,1417,239,712,178,705,113,19,22,15,16,4,7,15,22,15,22,0,12,54,62,15,23,39,42,5,8,5,8,0,12
14000US08013013205,"Census Tract 132.05, Boulder, CO",5072,555,2613,255,2459,408,4429,495,2305,275,2124,310,64,99,47,73,17,26,315,421,92,123,223,300,248,159,169,109,79,62,16,25,0,17,16,25
14000US08013013207,"Census Tract 132.07, Boulder, CO",4178,422,2030,234,2148,268,3680,427,1796,239,1884,269,149,75,38,27,111,57,123,82,87,57,36,33,190,202,109,106,81,100,36,39,0,12,36,39
14000US08013013208,"Census Tract 132.08, Boulder, CO",6355,630,2945,391,3410,440,5544,708,2597,378,2947,485,297,203,134,117,163,106,432,340,179,167,253,179,82,71,35,45,47,53,0,17,0,17,0,17
14000US08013013210,"Census Tract 132.10, Boulder, CO",5813,847,3116,489,2697,462,4975,790,2734,448,2241,441,677,305,332,154,345,173,136,84,33,26,103,77,25,27,17,19,8,12,0,17,0,17,0,17
14000US08013013211,"Census Tract 132.11, Boulder, CO",6472,1172,3085,632,3387,620,5040,649,2441,425,2599,329,364,241,165,115,199,148,259,283,69,72,190,215,809,963,410,471,399,499,0,17,0,17,0,17
14000US08013013212,"Census Tract 132.12, Boulder, CO",4899,574,2450,305,2449,381,4025,582,2052,296,1973,374,492,193,188,92,304,132,123,82,67,53,56,53,228,120,130,66,98,60,31,30,13,21,18,20
14000US08013013302,"Census Tract 133.02, Boulder, CO",4995,524,2546,345,2449,354,4092,500,2015,320,2077,327,409,175,222,109,187,125,151,157,97,99,54,65,326,177,212,133,114,76,17,26,0,12,17,26
14000US08013013305,"Census Tract 133.05, Boulder, CO",5594,867,2777,466,2817,500,4323,857,2112,419,2211,506,267,186,136,114,131,107,264,173,142,101,122,90,634,304,329,163,305,194,106,124,58,76,48,54
14000US08013013306,"Census Tract 133.06, Boulder, CO",4792,709,2390,315,2402,458,4165,758,2086,333,2079,477,291,197,141,106,150,102,264,184,131,80,133,113,72,81,32,37,40,54,0,12,0,12,0,12
14000US08013013307,"Census Tract 133.07, Boulder, CO",3983,413,1724,254,2259,251,3265,385,1371,243,1894,219,453,240,188,100,265,170,108,89,51,56,57,52,157,94,114,64,43,41,0,12,0,12,0,12
14000US08013013308,"Census Tract 133.08, Boulder, CO",3501,491,1690,306,1811,269,2931,518,1411,318,1520,266,227,135,91,80,136,88,241,104,154,82,87,58,89,74,34,30,55,64,13,21,0,12,13,21
14000US08013013401,"Census Tract 134.01, Boulder, CO",3031,403,1512,272,1519,241,1904,403,958,253,946,201,747,302,382,173,365,175,127,71,77,50,50,43,253,185,95,79,158,129,0,12,0,12,0,12
14000US08013013402,"Census Tract 134.02, Boulder, CO",7742,979,3491,525,4251,592,6805,977,3068,521,3737,589,518,323,166,116,352,217,89,102,80,89,9,37,330,369,177,209,153,164,0,17,0,17,0,17
14000US08013013503,"Census Tract 135.03, Boulder, CO",4950,614,2613,377,2337,362,4049,572,2044,341,2005,339,427,212,305,176,122,74,240,142,120,83,120,106,234,185,144,110,90,88,0,12,0,12,0,12
14000US08013013505,"Census Tract 135.05, Boulder, CO",4671,1177,2498,688,2173,550,3829,946,1952,480,1877,535,279,200,178,142,101,69,519,400,340,336,179,135,44,51,28,33,16,24,0,12,0,12,0,12
14000US08013013506,"Census Tract 135.06, Boulder, CO",4368,390,1890,198,2478,252,3885,425,1705,197,2180,280,245,162,107,74,138,94,118,86,40,44,78,60,102,62,38,31,64,44,18,26,0,12,18,26
14000US08013013507,"Census Tract 135.07, Boulder, CO",3385,345,1818,195,1567,226,2734,364,1456,222,1278,215,108,70,29,32,79,67,247,226,129,111,118,124,284,165,192,100,92,91,12,18,12,18,0,12
14000US08013013508,"Census Tract 135.08, Boulder, CO",7162,607,3329,385,3833,400,5919,613,2608,363,3311,430,504,268,253,169,251,145,445,327,296,211,149,141,294,189,172,123,122,88,0,17,0,17,0,17
14000US08013013601,"Census Tract 136.01, Boulder, CO",4110,387,2105,212,2005,232,3655,375,1844,196,1811,224,198,124,118,84,80,59,106,89,49,41,57,69,130,92,85,73,45,29,21,25,9,15,12,18
14000US08013013602,"Census Tract 136.02, Boulder, CO",1048,310,617,197,431,151,796,223,515,176,281,66,84,62,52,38,32,32,147,164,46,52,101,115,21,15,4,7,17,15,0,12,0,12,0,12
14000US08013060700,"Census Tract 607, Boulder, CO",2885,339,1459,189,1426,199,2511,310,1243,185,1268,178,111,45,63,37,48,31,95,61,51,45,44,42,156,92,90,68,66,45,12,16,12,16,0,12
14000US08013060900,"Census Tract 609, Boulder, CO",4796,549,2254,247,2542,410,4106,534,1873,234,2233,393,301,135,168,73,133,91,98,80,68,68,30,30,246,149,115,79,131,89,45,56,30,35,15,22
14000US08013061300,"Census Tract 613, Boulder, CO",3345,415,1727,268,1618,195,3132,414,1627,272,1505,190,112,75,49,37,63,48,15,13,0,12,15,13,60,63,37,42,23,22,26,29,14,16,12,14
14000US08013061400,"Census Tract 614, Boulder, CO",3981,459,1868,320,2113,241,3443,471,1693,330,1750,214,98,71,54,50,44,41,9,14,0,12,9,14,409,244,106,67,303,185,22,27,15,19,7,11
14000US08014030000,"Census Tract 300, Broomfield, CO",3625,435,1832,221,1793,298,2705,452,1357,244,1348,278,46,43,19,24,27,32,560,207,249,105,311,169,241,139,164,87,77,66,73,117,43,68,30,50
14000US08014030100,"Census Tract 301, Broomfield, CO",2536,441,1457,325,1079,159,2205,408,1251,301,954,147,45,36,28,22,17,18,232,125,157,88,75,42,37,37,21,32,16,18,17,23,0,12,17,23
14000US08014030200,"Census Tract 302, Broomfield, CO",1984,255,1080,197,904,133,1431,219,829,176,602,99,135,87,26,29,109,81,317,133,161,87,156,66,96,49,59,31,37,27,5,9,5,9,0,12
14000US08014030300,"Census Tract 303, Broomfield, CO",4104,465,2048,301,2056,269,3098,469,1494,280,1604,253,413,238,264,154,149,106,498,181,206,98,292,146,95,59,84,55,11,18,0,12,0,12,0,12
14000US08014030400,"Census Tract 304, Broomfield, CO",4072,477,2079,255,1993,327,3488,380,1787,205,1701,280,261,347,110,143,151,208,236,211,124,126,112,95,87,62,58,47,29,31,0,12,0,12,0,12
14000US08014030500,"Census Tract 305, Broomfield, CO",5525,530,2713,335,2812,278,5068,534,2459,334,2609,280,177,156,95,91,82,68,207,118,131,85,76,51,55,57,28,29,27,29,18,27,0,17,18,27
14000US08014030600,"Census Tract 306, Broomfield, CO",6056,673,2908,366,3148,413,5421,646,2691,370,2730,361,188,164,46,48,142,133,413,226,160,89,253,175,20,39,11,21,9,18,14,23,0,17,14,23
14000US08014030700,"Census Tract 307, Broomfield, CO",3067,378,1375,207,1692,221,2584,432,1139,208,1445,272,152,179,42,39,110,146,169,90,95,65,74,44,138,93,75,66,63,53,24,40,24,40,0,12
14000US08014030800,"Census Tract 308, Broomfield, CO",5911,531,2960,309,2951,308,5360,503,2725,274,2635,307,90,92,15,23,75,92,320,208,146,92,174,133,130,89,74,51,56,54,11,17,0,17,11,17
14000US08014030900,"Census Tract 309, Broomfield, CO",5574,576,2891,340,2683,341,4964,552,2587,313,2377,322,255,205,94,88,161,126,207,135,108,92,99,59,119,129,83,121,36,41,29,34,19,28,10,18
14000US08014031000,"Census Tract 310, Broomfield, CO",5727,546,2856,363,2871,334,4983,614,2510,396,2473,345,159,118,71,61,88,69,455,264,227,168,228,108,102,99,48,60,54,59,28,36,0,17,28,36
14000US08014031300,"Census Tract 313, Broomfield, CO",2620,346,1326,175,1294,210,2326,356,1172,178,1154,216,55,41,20,14,35,28,183,100,106,59,77,49,56,39,28,28,28,18,0,12,0,12,0,12
14000US08014980100,"Census Tract 9801, Broomfield, CO",0,12,0,12,0,12,0,12,0,12,0,12,0,12,0,12,0,12,0,12,0,12,0,12,0,12,0,12,0,12,0,12,0,12,0,12
14000US08014980200,"Census Tract 9802, Broomfield, CO",0,12,0,12,0,12,0,12,0,12,0,12,0,12,0,12,0,12,0,12,0,12,0,12,0,12,0,12,0,12,0,12,0,12,0,12
14000US08014980300,"Census Tract 9803, Broomfield, CO",0,12,0,12,0,12,0,12,0,12,0,12,0,12,0,12,0,12,0,12,0,12,0,12,0,12,0,12,0,12,0,12,0,12,0,12
14000US08015000100,"Census Tract 1, Chaffee, CO",2558,351,1232,254,1326,185,2166,316,1018,235,1148,159,283,170,119,80,164,108,107,108,93,108,14,18,2,5,2,5,0,12,0,12,0,12,0,12
14000US08015000200,"Census Tract 2, Chaffee, CO",4450,406,2235,249,2215,280,3848,405,1824,270,2024,270,248,117,165,84,83,89,300,177,200,122,100,81,40,61,32,48,8,14,14,22,14,22,0,12
14000US08015000300,"Census Tract 3, Chaffee, CO",3242,459,1642,284,1600,265,2879,426,1383,262,1496,247,126,102,105,92,21,27,120,105,89,87,31,34,10,17,0,12,10,17,107,135,65,84,42,52
14000US08015000402,"Census Tract 4.02, Chaffee, CO",5094,503,3181,338,1913,289,4487,558,2842,349,1645,316,264,230,184,168,80,87,279,238,124,114,155,141,64,101,31,49,33,52,0,17,0,17,0,17
14000US08017960600,"Census Tract 9606, Cheyenne, CO",1940,207,949,135,991,124,1780,194,872,127,908,119,58,40,26,25,32,21,57,35,22,15,35,27,30,22,14,13,16,13,15,20,15,20,0,12
14000US08019014800,"Census Tract 148, Clear Creek, CO",1725,296,835,228,890,175,1457,298,735,226,722,168,70,66,26,57,44,36,72,52,20,22,52,46,126,124,54,56,72,80,0,12,0,12,0,12
14000US08019014900,"Census Tract 149, Clear Creek, CO",2658,288,1359,186,1299,168,2260,273,1101,165,1159,160,195,121,103,80,92,71,153,62,124,60,29,23,47,69,28,56,19,25,3,4,3,4,0,12
14000US08021974800,"Census Tract 9748, Conejos, CO",3791,294,1998,155,1793,178,3358,279,1764,153,1594,163,172,63,118,48,54,33,120,70,68,45,52,35,129,63,47,29,82,40,12,13,1,2,11,13
14000US08021974900,"Census Tract 9749, Conejos, CO",4257,296,2051,152,2206,178,3907,299,1834,153,2073,179,133,66,79,39,54,36,168,127,105,80,63,52,40,42,27,31,13,14,9,13,6,9,3,5
14000US08023972600,"Census Tract 9726, Costilla, CO",2143,214,1063,105,1080,140,1922,223,938,107,984,140,72,60,52,39,20,23,49,42,21,24,28,21,100,60,52,35,48,30,0,12,0,12,0,12
14000US08023972700,"Census Tract 9727, Costilla, CO",1647,221,918,120,729,132,1377,182,706,100,671,140,67,41,30,26,37,34,71,44,71,44,0,12,113,93,105,83,8,12,19,28,6,11,13,19
14000US08029964600,"Census Tract 9646, Delta, CO",3908,457,2040,275,1868,233,3517,428,1904,264,1613,198,127,62,49,29,78,44,134,104,13,15,121,103,130,64,74,44,56,42,0,12,0,12,0,12
14000US08029964700,"Census Tract 9647, Delta, CO",4011,243,1792,191,2219,142,3270,426,1500,243,1770,224,356,227,104,71,252,168,200,151,97,86,103,83,129,135,35,50,94,87,56,86,56,86,0,12
14000US08029964800,"Census Tract 9648, Delta, CO",4018,456,2571,325,1447,211,3703,506,2385,340,1318,228,85,74,33,33,52,44,228,232,153,170,75,66,2,4,0,12,2,4,0,12,0,12,0,12
14000US08029964900,"Census Tract 9649, Delta, CO",5764,520,2795,293,2969,383,5176,501,2515,301,2661,348,306,161,189,108,117,96,77,65,49,52,28,36,205,114,42,62,163,104,0,17,0,17,0,17
14000US08029965100,"Census Tract 9651, Delta, CO",3625,463,1957,319,1668,245,3265,450,1804,319,1461,229,197,136,59,42,138,102,120,73,73,50,47,41,43,69,21,34,22,36,0,12,0,12,0,12
14000US08031000102,"Census Tract 1.02, Denver, CO",3612,508,1737,237,1875,337,3089,558,1466,268,1623,352,207,104,104,71,103,51,175,76,109,61,66,42,131,75,58,41,73,49,10,15,0,12,10,15
14000US08031000201,"Census Tract 2.01, Denver, CO",3381,505,1736,344,1645,281,2661,443,1341,336,1320,235,299,113,145,72,154,64,374,237,217,124,157,129,47,42,33,34,14,16,0,12,0,12,0,12
14000US08031000202,"Census Tract 2.02, Denver, CO",4370,781,2131,396,2239,574,3558,675,1777,306,1781,520,480,260,149,126,331,190,269,207,196,201,73,57,63,48,9,13,54,40,0,12,0,12,0,12
14000US08031000301,"Census Tract 3.01, Denver, CO",5308,547,2591,423,2717,370,4367,565,2149,404,2218,360,304,200,104,68,200,184,311,207,164,123,147,110,302,182,150,93,152,95,24,37,24,37,0,17
14000US08031000302,"Census Tract 3.02, Denver, CO",4747,813,2416,551,2331,494,3843,656,1905,508,1938,407,433,171,244,116,189,83,220,127,146,105,74,71,251,360,121,178,130,185,0,12,0,12,0,12
14000US08031000303,"Census Tract 3.03, Denver, CO",4997,896,2325,486,2672,469,4047,732,1793,378,2254,426,354,176,187,118,167,100,433,329,283,234,150,123,163,111,62,53,101,86,0,17,0,17,0,17
14000US08031000401,"Census Tract 4.01, Denver, CO",3728,731,1822,339,1906,585,2689,505,1450,316,1239,258,586,499,167,127,419,477,217,93,85,48,132,76,206,156,111,89,95,86,30,29,9,12,21,24
14000US08031000501,"Census Tract 5.01, Denver, CO",2141,204,1028,113,1113,135,1732,229,793,118,939,147,149,88,96,58,53,37,185,129,115,81,70,57,75,58,24,27,51,36,0,12,0,12,0,12
14000US08031000600,"Census Tract 6, Denver, CO",3394,560,1752,473,1642,247,2214,528,1149,427,1065,206,512,166,310,133,202,83,308,178,139,102,169,120,311,133,133,106,178,73,49,81,21,36,28,45
14000US08031000800,"Census Tract 8, Denver, CO",1366,351,640,216,726,190,1105,359,521,211,584,197,227,139,102,67,125,79,32,30,15,16,17,25,2,4,2,4,0,12,0,12,0,12,0,12
14000US08031000902,"Census Tract 9.02, Denver, CO",5989,670,3064,452,2925,425,5479,671,2863,465,2616,411,260,129,101,67,159,79,133,92,54,59,79,54,49,50,8,13,41,48,68,95,38,53,30,42
14000US08031000903,"Census Tract 9.03, Denver, CO",6464,954,3218,503,3246,616,6071,937,2964,501,3107,606,162,150,74,55,88,107,165,183,114,144,51,48,66,62,66,62,0,17,0,17,0,17,0,17
14000US08031000904,"Census Tract 9.04, Denver, CO",5392,863,3029,488,2363,469,4692,851,2624,469,2068,463,266,122,149,75,117,79,298,176,212,144,86,61,136,101,44,39,92,75,0,17,0,17,0,17
14000US08031000905,"Census Tract 9.05, Denver, CO",4161,507,2311,358,1850,309,3470,507,2017,360,1453,283,307,228,119,118,188,135,299,214,175,139,124,101,26,22,0,12,26,22,59,57,0,12,59,57
14000US08031001000,"Census Tract 10, Denver, CO",4877,827,2319,374,2558,609,4479,849,2181,384,2298,612,198,140,114,92,84,62,134,145,11,12,123,136,66,90,13,23,53,71,0,12,0,12,0,12
14000US08031001101,"Census Tract 11.01, Denver, CO",2481,344,1166,234,1315,200,2002,288,975,206,1027,166,258,165,99,83,159,97,133,64,69,42,64,39,77,55,23,23,54,39,11,17,0,12,11,17
14000US08031001102,"Census Tract 11.02, Denver, CO",4723,641,2415,366,2308,470,3279,584,1846,368,1433,370,607,262,273,137,334,176,191,91,88,65,103,65,576,236,202,113,374,162,70,64,6,11,64,63
14000US08031001301,"Census Tract 13.01, Denver, CO",5563,1077,2761,549,2802,607,5298,1065,2644,543,2654,602,63,42,47,39,16,18,69,45,30,23,39,29,40,43,20,29,20,31,93,118,20,33,73,87
14000US08031001302,"Census Tract 13.02, Denver, CO",3981,661,1766,392,2215,393,3594,654,1684,394,1910,372,257,159,49,40,208,142,103,77,33,34,70,66,27,30,0,12,27,30,0,12,0,12,0,12
14000US08031001401,"Census Tract 14.01, Denver, CO",5446,560,2862,360,2584,314,4835,574,2580,357,2255,311,441,231,191,100,250,162,94,94,34,37,60,66,76,85,57,66,19,31,0,17,0,17,0,17
14000US08031001402,"Census Tract 14.02, Denver, CO",4723,1073,2530,470,2193,687,4403,1051,2339,443,2064,678,261,178,153,158,108,69,54,74,33,44,21,32,5,10,5,10,0,12,0,12,0,12,0,12
14000US08031001403,"Census Tract 14.03, Denver, CO",3380,583,1705,304,1675,368,2395,606,1134,296,1261,382,390,195,220,116,170,104,336,166,228,139,108,75,259,135,123,66,136,79,0,12,0,12,0,12
14000US08031001500,"Census Tract 15, Denver, CO",4439,668,2714,533,1725,285,3566,577,2297,463,1269,254,169,91,78,73,91,53,461,226,220,155,241,119,187,176,81,90,106,102,56,54,38,46,18,20
14000US08031001800,"Census Tract 18, Denver, CO",3281,395,1756,311,1525,225,2566,441,1492,301,1074,235,348,137,144,96,204,99,169,98,49,44,120,76,198,92,71,67,127,58,0,12,0,12,0,12
14000US08031001901,"Census Tract 19.01, Denver, CO",3471,624,1812,428,1659,320,2765,499,1503,431,1262,250,333,156,178,100,155,91,194,182,42,34,152,177,163,85,73,53,90,69,16,20,16,20,0,12
14000US08031002000,"Census Tract 20, Denver, CO",2485,360,1205,200,1280,244,1820,370,888,211,932,212,395,146,178,85,217,108,119,87,87,75,32,42,151,82,52,35,99,60,0,12,0,12,0,12
14000US08031002300,"Census Tract 23, Denver, CO",5291,683,2394,486,2897,375,4492,692,1960,465,2532,390,633,304,364,224,269,136,67,55,44,47,23,26,99,91,26,40,73,72,0,17,0,17,0,17
14000US08031002402,"Census Tract 24.02, Denver, CO",1994,308,910,142,1084,211,1637,304,774,136,863,199,182,77,76,43,106,51,71,42,22,16,49,33,98,57,35,31,63,39,6,11,3,6,3,5
14000US08031002602,"Census Tract 26.02, Denver, CO",3036,485,1285,218,1751,437,1984,453,932,187,1052,436,319,149,108,73,211,115,252,98,93,65,159,89,474,248,152,112,322,158,7,11,0,12,7,11
14000US08031002801,"Census Tract 28.01, Denver, CO",2939,353,1240,187,1699,318,2223,304,907,162,1316,266,387,122,147,78,240,98,107,62,69,51,38,31,206,101,117,71,89,65,16,23,0,12,16,23
14000US08031002802,"Census Tract 28.02, Denver, CO",4462,859,2392,699,2070,377,2917,408,1702,342,1215,243,541,363,320,366,221,109,366,165,122,66,244,141,624,391,248,253,376,269,14,21,0,12,14,21
14000US08031002901,"Census Tract 29.01, Denver, CO",3405,376,1889,278,1516,266,2518,326,1347,215,1171,253,464,158,314,117,150,68,207,142,141,104,66,66,205,86,76,45,129,71,11,18,11,18,0,12
14000US08031002902,"Census Tract 29.02, Denver, CO",4178,479,2310,375,1868,219,3484,502,1963,378,1521,228,340,103,135,55,205,78,113,78,79,49,34,37,171,86,96,66,75,49,70,90,37,46,33,44
14000US08031003002,"Census Tract 30.02, Denver, CO",2986,402,1323,209,1663,371,2489,414,1117,191,1372,378,254,110,125,77,129,72,143,59,56,28,87,47,94,77,19,20,75,70,6,9,6,9,0,12
14000US08031003003,"Census Tract 30.03, Denver, CO",3213,458,1687,370,1526,249,1867,433,1082,299,785,172,238,90,103,57,135,69,398,148,142,103,256,105,618,228,298,116,320,178,92,51,62,45,30,37
14000US08031003004,"Census Tract 30.04, Denver, CO",6705,887,3385,449,3320,650,5332,864,2678,487,2654,551,519,178,289,129,230,117,256,107,123,69,133,61,555,248,270,139,285,131,43,48,25,39,18,30
14000US08031003101,"Census Tract 31.01, Denver, CO",1746,295,816,154,930,228,1545,294,716,148,829,226,53,29,18,23,35,26,81,57,54,42,27,19,59,75,24,32,35,44,8,12,4,6,4,6
14000US08031003102,"Census Tract 31.02, Denver, CO",3396,420,1686,330,1710,272,2304,368,1277,282,1027,173,499,184,214,142,285,125,221,124,64,65,157,113,352,133,121,72,231,89,20,35,10,17,10,18
14000US08031003202,"Census Tract 32.02, Denver, CO",3386,378,1739,341,1647,219,2591,378,1380,343,1211,157,290,117,174,94,116,61,215,138,53,56,162,117,279,123,121,76,158,75,11,17,11,17,0,12
14000US08031003203,"Census Tract 32.03, Denver, CO",3138,508,1738,328,1400,229,2938,508,1586,322,1352,226,88,58,69,51,19,18,16,16,16,16,0,12,89,59,67,52,22,19,7,12,0,12,7,12
14000US08031003300,"Census Tract 33, Denver, CO",3130,457,1653,285,1477,234,2723,454,1492,302,1231,196,210,144,63,45,147,108,41,43,25,37,16,21,156,94,73,50,83,55,0,12,0,12,0,12
14000US08031003401,"Census Tract 34.01, Denver, CO",2539,247,1269,141,1270,184,2262,242,1112,142,1150,177,163,94,84,52,79,58,67,56,44,32,23,28,47,39,29,25,18,19,0,12,0,12,0,12
14000US08031003402,"Census Tract 34.02, Denver, CO",4974,670,2569,414,2405,365,4380,683,2178,405,2202,363,237,132,163,94,74,59,119,105,57,65,62,56,166,156,124,118,42,43,72,78,47,62,25,38
14000US08031003601,"Census Tract 36.01, Denver, CO",4867,736,2738,547,2129,349,4330,753,2490,557,1840,337,297,130,105,51,192,99,100,60,50,33,50,45,130,90,83,84,47,33,10,15,10,15,0,12
14000US08031003602,"Census Tract 36.02, Denver, CO",4673,575,2408,390,2265,419,3720,621,1981,382,1739,425,551,200,310,131,241,132,149,99,69,48,80,61,247,159,42,39,205,148,6,9,6,9,0,12
14000US08031003603,"Census Tract 36.03, Denver, CO",3456,472,1545,293,1911,446,2870,341,1323,278,1547,361,120,85,58,56,62,57,83,65,21,23,62,56,383,268,143,121,240,211,0,12,0,12,0,12
14000US08031003701,"Census Tract 37.01, Denver, CO",3351,362,1600,285,1751,276,2644,361,1349,273,1295,221,349,130,125,61,224,104,151,73,43,40,108,68,190,94,83,48,107,70,17,35,0,12,17,35
14000US08031003702,"Census Tract 37.02, Denver, CO",5131,791,2746,555,2385,393,3722,743,2009,469,1713,372,733,327,434,246,299,168,317,176,120,87,197,158,313,153,183,113,130,93,46,73,0,17,46,73
14000US08031003703,"Census Tract 37.03, Denver, CO",3013,369,1393,194,1620,261,2201,231,1040,165,1161,170,508,328,196,133,312,210,76,45,37,41,39,32,125,72,53,43,72,41,103,117,67,74,36,43
14000US08031003901,"Census Tract 39.01, Denver, CO",4193,664,1852,367,2341,406,3273,544,1419,297,1854,363,444,485,200,241,244,255,294,195,155,103,139,100,182,100,78,73,104,69,0,12,0,12,0,12
14000US08031003902,"Census Tract 39.02, Denver, CO",4131,363,2251,241,1880,186,3615,349,1932,215,1683,180,296,133,160,76,136,65,74,73,67,70,7,12,124,62,84,44,40,28,22,26,8,11,14,23
14000US08031004002,"Census Tract 40.02, Denver, CO",3485,352,1752,208,1733,220,3141,404,1589,218,1552,241,230,144,112,74,118,84,42,28,18,22,24,15,72,56,33,28,39,36,0,12,0,12,0,12
14000US08031004003,"Census Tract 40.03, Denver, CO",4827,1447,2430,954,2397,561,3259,478,1468,265,1791,298,334,136,150,64,184,89,270,163,166,120,104,85,964,1326,646,923,318,408,0,12,0,12,0,12
14000US08031004004,"Census Tract 40.04, Denver, CO",1905,180,912,139,993,123,1736,180,819,123,917,122,38,33,11,10,27,25,107,87,71,72,36,32,24,29,11,12,13,19,0,12,0,12,0,12
14000US08031004005,"Census Tract 40.05, Denver, CO",3220,453,1459,217,1761,378,2038,250,1012,164,1026,159,633,284,201,93,432,265,181,87,104,53,77,64,327,287,124,130,203,166,41,44,18,21,23,38
14000US08031004006,"Census Tract 40.06, Denver, CO",4872,603,2224,493,2648,412,4094,496,2041,457,2053,300,344,223,85,76,259,187,254,200,34,39,220,194,158,106,64,57,94,68,22,35,0,12,22,35
14000US08031004101,"Census Tract 41.01, Denver, CO",4564,557,2164,402,2400,284,3593,524,1605,309,1988,316,355,143,195,102,160,82,461,215,276,151,185,135,150,88,83,53,67,54,5,9,5,9,0,12
14000US08031004102,"Census Tract 41.02, Denver, CO",5225,888,2643,501,2582,605,4296,824,2107,403,2189,593,413,186,230,169,183,93,357,183,181,130,176,109,145,125,125,125,20,22,14,23,0,17,14,23
14000US08031004103,"Census Tract 41.03, Denver, CO",6353,1215,2882,690,3471,693,5229,1109,2373,688,2856,619,223,181,126,134,97,88,497,361,275,226,222,148,285,404,108,171,177,237,119,167,0,17,119,167
14000US08031004104,"Census Tract 41.04, Denver, CO",5100,605,2569,384,2531,325,4465,623,2171,381,2294,341,293,200,150,111,143,100,112,96,66,66,46,52,230,143,182,127,48,46,0,17,0,17,0,17
14000US08031004201,"Census Tract 42.01, Denver, CO",4806,485,2320,254,2486,315,4213,447,1985,227,2228,295,264,134,133,81,131,68,78,69,60,63,18,19,242,184,133,112,109,89,9,15,9,15,0,12
14000US08031004202,"Census Tract 42.02, Denver, CO",4603,562,2152,390,2451,300,3885,520,1910,365,1975,275,221,96,71,44,150,69,130,84,49,41,81,62,342,128,103,50,239,100,25,24,19,22,6,12
14000US08031004302,"Census Tract 43.02, Denver, CO",2988,684,1384,324,1604,398,2594,690,1164,330,1430,389,251,193,158,141,93,62,32,35,10,14,22,28,111,66,52,38,59,42,0,12,0,12,0,12
14000US08031004303,"Census Tract 43.03, Denver, CO",3961,413,1779,253,2182,230,3617,420,1598,248,2019,239,265,142,133,85,132,78,17,26,8,13,9,13,62,53,40,39,22,27,0,12,0,12,0,12
14000US08031004306,"Census Tract 43.06, Denver, CO",4724,451,2094,301,2630,333,3489,445,1600,275,1889,329,558,251,159,95,399,212,320,173,131,90,189,98,256,238,137,155,119,103,101,99,67,76,34,34
14000US08031004403,"Census Tract 44.03, Denver, CO",4390,581,2122,352,2268,351,3466,447,1549,249,1917,307,196,107,132,83,64,42,325,193,282,186,43,36,403,197,159,81,244,187,0,12,0,12,0,12
14000US08031004404,"Census Tract 44.04, Denver, CO",5959,591,3150,401,2809,404,4881,731,2644,451,2237,433,431,196,189,126,242,123,224,206,100,95,124,119,367,292,198,156,169,161,56,67,19,27,37,60
14000US08031004503,"Census Tract 45.03, Denver, CO",5000,1071,2351,575,2649,607,4643,1084,2223,579,2420,599,222,124,82,69,140,85,113,122,46,60,67,70,14,22,0,17,14,22,8,12,0,17,8,12
14000US08031004504,"Census Tract 45.04, Denver, CO",4432,602,2032,332,2400,426,4294,610,1983,336,2311,425,55,41,31,34,24,28,13,21,0,12,13,21,70,59,18,21,52,47,0,12,0,12,0,12
14000US08031004505,"Census Tract 45.05, Denver, CO",5062,793,2573,479,2489,399,4599,777,2431,479,2168,389,236,230,71,94,165,143,173,171,38,44,135,133,3,9,0,17,3,9,51,76,33,49,18,27
14000US08031004506,"Census Tract 45.06, Denver, CO",3633,415,1915,318,1718,240,3471,432,1822,316,1649,248,117,95,59,49,58,58,45,53,34,43,11,13,0,12,0,12,0,12,0,12,0,12,0,12
14000US08031004601,"Census Tract 46.01, Denver, CO",6846,1046,3352,618,3494,583,6436,1045,3143,612,3293,571,219,140,141,107,78,74,174,164,60,72,114,129,17,27,8,14,9,14,0,17,0,17,0,17
14000US08031004602,"Census Tract 46.02, Denver, CO",7015,882,3732,670,3283,465,6608,877,3540,666,3068,458,229,129,102,78,127,83,123,141,54,72,69,75,55,67,36,57,19,31,0,17,0,17,0,17
14000US08031004603,"Census Tract 46.03, Denver, CO",5931,727,3031,387,2900,468,5452,745,2744,403,2708,458,250,136,142,98,108,81,185,117,141,106,44,33,38,29,4,7,34,27,6,9,0,17,6,9
14000US08031004700,"Census Tract 47, Denver, CO",7269,973,3414,513,3855,736,5907,1089,2574,490,3333,783,597,305,314,181,283,143,161,138,74,79,87,123,405,448,280,305,125,151,199,265,172,265,27,42
14000US08031004801,"Census Tract 48.01, Denver, CO",3771,564,1910,440,1861,305,3581,561,1799,439,1782,294,107,81,44,42,63,57,77,84,61,65,16,28,6,9,6,9,0,12,0,12,0,12,0,12
14000US08031005001,"Census Tract 50.01, Denver, CO",2606,265,1290,199,1316,186,2175,318,983,206,1192,180,151,101,107,88,44,34,128,98,87,77,41,42,94,87,55,69,39,36,58,56,58,56,0,12
14000US08031005102,"Census Tract 51.02, Denver, CO",3729,453,2031,301,1698,234,3275,459,1738,289,1537,235,250,133,162,101,88,63,95,70,52,36,43,41,97,85,79,71,18,23,12,11,0,12,12,11
14000US08031005104,"Census Tract 51.04, Denver, CO",3915,570,1977,317,1938,335,3331,552,1704,304,1627,322,375,182,182,89,193,131,83,48,65,42,18,18,89,65,26,30,63,54,37,42,0,12,37,42
14000US08031005200,"Census Tract 52, Denver, CO",3615,531,1686,319,1929,339,3149,544,1477,334,1672,320,325,154,141,93,184,97,44,37,20,26,24,23,65,51,48,45,17,21,32,37,0,12,32,37
14000US08031005300,"Census Tract 53, Denver, CO",1707,295,845,172,862,188,1337,274,599,142,738,190,209,113,164,110,45,34,110,64,60,40,50,31,46,31,17,14,29,21,5,8,5,8,0,12
14000US08031005502,"Census Tract 55.02, Denver, CO",2011,299,1048,229,963,155,1529,276,764,205,765,137,137,98,75,81,62,46,297,120,172,85,125,68,48,43,37,40,11,16,0,12,0,12,0,12
14000US08031005503,"Census Tract 55.03, Denver, CO",5161,742,2270,356,2891,510,4656,729,1972,307,2684,515,94,73,29,33,65,46,255,113,159,96,96,54,148,144,102,86,46,70,8,13,8,13,0,17
14000US08031006701,"Census Tract 67.01, Denver, CO",4102,421,2299,301,1803,229,1949,281,1060,194,889,174,432,155,251,98,181,89,809,301,474,217,335,131,899,323,507,169,392,172,13,11,7,11,6,10
14000US08031006804,"Census Tract 68.04, Denver, CO",3050,287,1618,217,1432,181,2095,246,1102,189,993,158,247,126,135,73,112,66,419,190,262,137,157,79,260,105,119,60,141,74,29,33,0,12,29,33
14000US08031006810,"Census Tract 68.10, Denver, CO",6241,858,3087,490,3154,555,5253,797,2512,422,2741,518,386,382,213,239,173,160,426,181,283,145,143,96,138,111,68,94,70,67,38,44,11,17,27,33
14000US08031006812,"Census Tract 68.12, Denver, CO",4141,702,2018,413,2123,435,3172,480,1610,320,1562,342,166,98,99,65,67,50,491,411,251,255,240,180,190,196,16,22,174,192,122,188,42,65,80,123
14000US08031006813,"Census Tract 68.13, Denver, CO",4377,902,1809,542,2568,585,3504,975,1501,545,2003,537,215,200,90,102,125,111,451,222,148,139,303,190,171,174,42,60,129,160,36,45,28,44,8,12
14000US08031006814,"Census Tract 68.14, Denver, CO",4784,650,2279,386,2505,565,3865,749,1945,416,1920,492,660,510,185,136,475,384,83,117,0,12,83,117,176,214,149,168,27,51,0,12,0,12,0,12
14000US08031007006,"Census Tract 70.06, Denver, CO",4128,790,2240,445,1888,472,2342,625,1345,410,997,333,629,466,220,196,409,358,670,349,393,229,277,167,428,310,239,223,189,152,59,56,43,44,16,25
14000US08031007013,"Census Tract 70.13, Denver, CO",4239,810,1837,436,2402,474,3530,775,1577,411,1953,439,179,151,91,102,88,62,365,151,139,89,226,126,165,128,30,25,135,127,0,12,0,12,0,12
14000US08031007037,"Census Tract 70.37, Denver, CO",4529,995,2430,487,2099,722,3595,922,1865,399,1730,661,128,129,70,70,58,84,513,291,325,225,188,123,258,156,161,139,97,76,35,38,9,14,26,28
14000US08031007088,"Census Tract 70.88, Denver, CO",5168,810,2337,398,2831,611,3688,785,1745,403,1943,564,403,234,166,127,237,150,340,230,143,90,197,153,545,257,177,108,368,211,192,252,106,134,86,119
14000US08031008304,"Census Tract 83.04, Denver, CO",4074,930,2037,430,2037,580,3662,876,1825,399,1837,551,241,142,153,89,88,65,72,53,44,33,28,32,99,77,15,24,84,74,0,12,0,12,0,12
14000US08031008305,"Census Tract 83.05, Denver, CO",5646,1191,2849,576,2797,715,4999,1126,2550,539,2449,685,230,165,94,57,136,125,185,118,142,86,43,58,170,126,36,34,134,107,62,40,27,28,35,34
14000US08031008306,"Census Tract 83.06, Denver, CO",7017,1057,3774,603,3243,579,5743,920,3061,544,2682,510,398,266,294,215,104,73,348,164,190,105,158,90,424,405,218,242,206,186,104,124,11,15,93,120
14000US08031008312,"Census Tract 83.12, Denver, CO",7368,871,3667,533,3701,450,6537,940,3304,578,3233,447,198,146,122,123,76,67,363,277,172,118,191,178,188,249,69,78,119,180,82,118,0,17,82,118
14000US08031008386,"Census Tract 83.86, Denver, CO",4837,560,2460,349,2377,378,4358,651,2151,400,2207,402,17,33,17,33,0,12,380,306,241,178,139,135,61,66,30,38,31,47,21,61,21,61,0,12
14000US08031008387,"Census Tract 83.87, Denver, CO",7243,978,3610,482,3633,621,6976,1005,3436,493,3540,628,39,39,17,22,22,32,171,147,122,106,49,52,28,46,26,45,2,4,29,58,9,18,20,40
14000US08031008388,"Census Tract 83.88, Denver, CO",11123,1458,5312,800,5811,901,7881,1278,3807,732,4074,733,1619,806,798,390,821,471,962,534,359,230,603,377,609,387,320,270,289,169,52,78,28,42,24,36
14000US08031008389,"Census Tract 83.89, Denver, CO",13855,2365,6382,991,7473,1480,11739,2361,5391,999,6348,1472,812,404,445,233,367,205,722,391,343,212,379,223,479,234,203,118,276,149,103,103,0,19,103,103
14000US08031008390,"Census Tract 83.90, Denver, CO",9329,1143,4600,692,4729,661,7446,868,3546,465,3900,616,330,204,200,153,130,151,1337,815,683,414,654,453,216,153,171,144,45,69,0,17,0,17,0,17
14000US08031008391,"Census Tract 83.91, Denver, CO",7266,966,3722,668,3544,504,6603,971,3497,697,3106,429,141,190,44,53,97,139,252,210,129,113,123,105,258,192,52,65,206,152,12,21,0,17,12,21
14000US08031011902,"Census Tract 119.02, Denver, CO",5991,1110,2905,658,3086,700,4932,828,2275,535,2657,610,466,361,368,339,98,67,516,272,262,190,254,182,11,19,0,17,11,19,66,107,0,17,66,107
14000US08031011903,"Census Tract 119.03, Denver, CO",2564,309,1324,224,1240,168,2305,345,1147,232,1158,178,31,21,15,16,16,14,183,98,140,83,43,32,45,35,22,21,23,24,0,12,0,12,0,12
14000US08031012001,"Census Tract 120.01, Denver, CO",2116,332,1044,185,1072,202,2023,331,982,186,1041,201,25,27,25,27,0,12,68,46,37,36,31,24,0,12,0,12,0,12,0,12,0,12,0,12
14000US08031012010,"Census Tract 120.10, Denver, CO",5400,732,2350,441,3050,462,3910,664,1621,305,2289,412,262,197,101,89,161,134,850,539,437,385,413,257,360,222,191,132,169,125,18,28,0,17,18,28
14000US08031015300,"Census Tract 153, Denver, CO",3946,619,2298,556,1648,299,2986,620,1775,525,1211,282,296,155,202,115,94,70,541,237,264,122,277,182,123,100,57,50,66,68,0,12,0,12,0,12
14000US08031015400,"Census Tract 154, Denver, CO",5255,725,2208,333,3047,503,3895,478,1616,265,2279,317,384,187,169,111,215,108,691,467,227,149,464,335,253,131,164,101,89,66,32,33,32,33,0,17
14000US08031015500,"Census Tract 155, Denver, CO",3410,402,1754,294,1656,288,2126,376,1179,289,947,247,557,188,215,98,342,138,340,139,140,66,200,97,348,129,201,100,147,75,39,48,19,21,20,32
14000US08031015600,"Census Tract 156, Denver, CO",8652,1369,4724,952,3928,698,7973,1370,4417,944,3556,707,315,232,148,124,167,118,266,253,91,108,175,162,98,107,68,72,30,37,0,17,0,17,0,17
14000US08031015700,"Census Tract 157, Denver, CO",5998,1058,3416,866,2582,467,5052,957,2828,760,2224,440,516,415,367,400,149,85,319,204,160,99,159,150,53,45,48,39,5,11,58,95,13,22,45,73
14000US08031980100,"Census Tract 9801, Denver, CO",0,12,0,12,0,12,0,12,0,12,0,12,0,12,0,12,0,12,0,12,0,12,0,12,0,12,0,12,0,12,0,12,0,12,0,12
14000US08033000100,"Census Tract 1, Dolores, CO",1865,210,1016,150,849,121,1766,208,980,150,786,118,10,17,3,6,7,12,15,10,5,9,10,11,74,70,28,27,46,44,0,12,0,12,0,12
14000US08035013904,"Census Tract 139.04, Douglas, CO",4183,528,2156,306,2027,306,3058,501,1540,293,1518,283,442,173,237,105,205,97,529,205,311,136,218,92,112,62,68,43,44,36,42,58,0,12,42,58
14000US08035013905,"Census Tract 139.05, Douglas, CO",4423,447,2019,259,2404,302,3191,455,1481,220,1710,292,294,144,160,85,134,88,589,270,247,148,342,167,287,171,131,93,156,85,62,83,0,12,62,83
14000US08035013907,"Census Tract 139.07, Douglas, CO",5849,685,2561,344,3288,457,4700,658,2014,304,2686,468,409,368,193,174,216,197,591,268,271,128,320,155,149,108,83,75,66,60,0,17,0,17,0,17
14000US08035013909,"Census Tract 139.09, Douglas, CO",5908,771,2834,412,3074,452,5475,798,2637,430,2838,456,141,154,61,85,80,79,87,138,66,105,21,33,181,172,70,81,111,108,24,38,0,17,24,38
14000US08035013910,"Census Tract 139.10, Douglas, CO",7670,768,4035,451,3635,443,6729,704,3461,396,3268,430,266,265,149,152,117,119,410,310,229,181,181,137,241,212,172,142,69,72,24,35,24,35,0,17
14000US08035013911,"Census Tract 139.11, Douglas, CO",7656,1122,3812,581,3844,634,6534,1063,3246,464,3288,669,667,537,391,317,276,255,188,161,104,87,84,83,267,219,71,67,196,203,0,17,0,17,0,17
14000US08035014005,"Census Tract 140.05, Douglas, CO",4855,461,2329,331,2526,244,4130,420,1931,307,2199,227,427,197,227,111,200,103,174,112,107,68,67,52,114,86,64,55,50,47,10,17,0,12,10,17
14000US08035014006,"Census Tract 140.06, Douglas, CO",6801,507,3419,316,3382,308,6059,509,3053,316,3006,291,293,175,153,98,140,91,225,177,75,56,150,131,186,139,124,94,62,51,38,49,14,19,24,31
14000US08035014007,"Census Tract 140.07, Douglas, CO",3570,433,1956,288,1614,242,2394,423,1283,276,1111,219,364,193,170,117,194,98,371,190,235,160,136,60,405,192,260,117,145,108,36,36,8,12,28,28
14000US08035014008,"Census Tract 140.08, Douglas, CO",9722,879,4773,527,4949,477,7655,749,3761,432,3894,420,712,345,332,205,380,201,835,498,461,308,374,211,491,309,219,154,272,177,29,49,0,17,29,49
14000US08035014009,"Census Tract 140.09, Douglas, CO",4222,615,2189,302,2033,365,3487,534,1845,279,1642,305,256,176,138,97,118,103,120,103,68,55,52,61,304,227,110,84,194,162,55,85,28,46,27,40
14000US08035014010,"Census Tract 140.10, Douglas, CO",6185,749,3234,511,2951,455,5158,737,2729,498,2429,401,397,235,129,96,268,178,197,141,157,107,40,50,399,218,185,115,214,166,34,47,34,47,0,17
14000US08035014011,"Census Tract 140.11, Douglas, CO",6187,664,3173,405,3014,363,4660,656,2468,415,2192,313,563,266,332,158,231,135,738,307,328,142,410,189,154,91,45,39,109,74,72,93,0,17,72,93
14000US08035014013,"Census Tract 140.13, Douglas, CO",8803,821,4197,447,4606,483,7285,726,3485,341,3800,467,607,253,299,134,308,135,464,295,240,179,224,165,447,259,173,115,274,153,0,17,0,17,0,17
14000US08035014107,"Census Tract 141.07, Douglas, CO",4074,518,1880,222,2194,369,3889,520,1800,232,2089,361,33,31,11,14,22,23,73,70,40,36,33,37,79,63,29,35,50,38,0,12,0,12,0,12
14000US08035014108,"Census Tract 141.08, Douglas, CO",5152,721,2469,384,2683,394,4849,727,2315,382,2534,398,85,87,32,34,53,53,138,75,74,50,64,41,80,64,48,47,32,33,0,17,0,17,0,17
14000US08035014109,"Census Tract 141.09, Douglas, CO",3116,453,1456,285,1660,239,2981,447,1359,280,1622,238,36,47,26,34,10,14,63,56,44,45,19,22,36,39,27,29,9,13,0,12,0,12,0,12
14000US08035014110,"Census Tract 141.10, Douglas, CO",5564,616,2985,465,2579,315,4221,550,2172,400,2049,289,327,199,146,91,181,137,320,204,161,122,159,108,532,378,381,292,151,104,164,226,125,184,39,46
14000US08035014112,"Census Tract 141.12, Douglas, CO",3719,301,1823,200,1896,201,3450,332,1651,202,1799,216,85,82,53,48,32,39,18,29,18,29,0,12,152,133,87,91,65,52,14,24,14,24,0,12
14000US08035014113,"Census Tract 141.13, Douglas, CO",3247,331,1738,216,1509,163,2951,334,1573,222,1378,154,174,105,91,55,83,60,54,36,32,25,22,20,62,68,36,37,26,31,6,9,6,9,0,12
14000US08035014114,"Census Tract 141.14, Douglas, CO",3418,370,1685,242,1733,222,2751,317,1335,213,1416,190,136,120,76,72,60,66,367,308,194,170,173,153,136,82,80,47,56,44,28,37,0,12,28,37
14000US08035014115,"Census Tract 141.15, Douglas, CO",4528,362,2172,208,2356,245,3614,452,1728,246,1886,262,434,178,219,126,215,129,336,227,155,100,181,146,144,80,70,41,74,49,0,12,0,12,0,12
14000US08035014116,"Census Tract 141.16, Douglas, CO",5196,484,2668,308,2528,397,3074,554,1652,344,1422,270,833,606,361,246,472,429,534,274,304,158,230,135,576,239,229,153,347,165,179,211,122,156,57,65
14000US08035014123,"Census Tract 141.23, Douglas, CO",4086,504,2238,351,1848,256,2973,485,1582,310,1391,241,430,175,254,119,176,88,309,148,190,104,119,81,374,200,212,126,162,95,0,12,0,12,0,12
14000US08035014124,"Census Tract 141.24, Douglas, CO",5691,587,2809,282,2882,394,5159,577,2485,287,2674,381,277,174,159,95,118,83,154,144,99,95,55,53,73,60,44,34,29,30,28,45,22,34,6,11
14000US08035014125,"Census Tract 141.25, Douglas, CO",5292,663,2649,368,2643,374,3891,553,1941,303,1950,311,653,311,264,139,389,201,505,222,355,193,150,77,243,126,89,63,154,87,0,17,0,17,0,17
14000US08035014126,"Census Tract 141.26, Douglas, CO",2244,382,974,150,1270,276,1709,395,680,144,1029,283,293,105,166,71,127,58,90,51,54,37,36,24,107,64,47,35,60,42,45,50,27,28,18,23
14000US08035014127,"Census Tract 141.27, Douglas, CO",5126,597,2550,337,2576,339,4472,571,2217,343,2255,307,572,403,295,190,277,219,59,50,34,33,25,27,15,19,4,6,11,17,8,12,0,17,8,12
14000US08035014128,"Census Tract 141.28, Douglas, CO",5193,766,2446,356,2747,497,4421,592,2150,353,2271,303,273,132,132,61,141,76,238,148,126,94,112,70,242,290,38,35,204,285,19,29,0,17,19,29
14000US08035014129,"Census Tract 141.29, Douglas, CO",3575,299,1786,199,1789,194,3256,309,1595,189,1661,194,98,94,54,47,44,52,193,114,117,82,76,53,28,28,20,22,8,14,0,12,0,12,0,12
14000US08035014130,"Census Tract 141.30, Douglas, CO",7353,977,3804,613,3549,432,6032,514,3035,328,2997,298,250,167,116,80,134,98,90,72,74,70,16,25,981,869,579,555,402,324,0,17,0,17,0,17
14000US08035014131,"Census Tract 141.31, Douglas, CO",5423,567,2770,395,2653,294,3560,424,1772,306,1788,219,604,231,330,142,274,130,745,453,374,278,371,199,429,185,233,107,196,87,85,79,61,58,24,30
14000US08035014132,"Census Tract 141.32, Douglas, CO",6707,605,3317,388,3390,295,6141,639,3070,402,3071,309,154,102,53,49,101,77,113,73,44,45,69,45,253,160,118,81,135,86,46,50,32,45,14,22
14000US08035014133,"Census Tract 141.33, Douglas, CO",6028,620,3080,364,2948,335,5496,662,2833,376,2663,355,325,245,170,138,155,113,179,156,72,82,107,94,28,38,5,10,23,37,0,17,0,17,0,17
14000US08035014134,"Census Tract 141.34, Douglas, CO",6381,631,3205,377,3176,363,5862,606,2968,360,2894,352,353,218,157,111,196,117,117,98,67,58,50,49,36,40,0,17,36,40,13,21,13,21,0,17
14000US08035014135,"Census Tract 141.35, Douglas, CO",5502,787,2846,544,2656,329,4858,791,2530,558,2328,305,290,134,133,78,157,78,61,51,24,29,37,28,270,249,136,128,134,131,23,19,23,19,0,17
14000US08035014138,"Census Tract 141.38, Douglas, CO",2973,310,1469,199,1504,215,1907,278,963,157,944,198,358,179,138,92,220,129,292,121,109,61,183,89,320,161,186,97,134,79,96,120,73,87,23,35
14000US08035014139,"Census Tract 141.39, Douglas, CO",3622,280,1754,185,1868,146,3345,280,1618,174,1727,149,38,42,19,23,19,20,193,103,91,58,102,59,20,23,12,19,8,14,26,30,14,22,12,18
14000US08035014140,"Census Tract 141.40, Douglas, CO",5716,488,2768,277,2948,304,4638,407,2155,235,2483,245,518,409,256,196,262,233,364,273,232,182,132,95,150,134,95,70,55,69,46,47,30,33,16,26
14000US08035014203,"Census Tract 142.03, Douglas, CO",5921,587,3006,342,2915,352,5468,569,2785,318,2683,355,72,107,38,56,34,51,226,237,129,134,97,104,117,94,54,46,63,50,38,60,0,17,38,60
14000US08035014300,"Census Tract 143, Douglas, CO",939,187,494,95,445,109,882,184,462,90,420,109,9,13,0,12,9,13,35,29,19,18,16,15,13,15,13,15,0,12,0,12,0,12,0,12
14000US08035014404,"Census Tract 144.04, Douglas, CO",2384,273,1187,169,1197,142,2140,265,1059,165,1081,137,137,91,82,64,55,36,84,60,34,23,50,44,15,22,8,11,7,11,8,15,4,8,4,7
14000US08035014405,"Census Tract 144.05, Douglas, CO",7183,728,3760,431,3423,417,6547,755,3421,453,3126,407,228,153,149,100,79,64,227,121,90,65,137,83,181,131,100,87,81,72,0,17,0,17,0,17
14000US08035014503,"Census Tract 145.03, Douglas, CO",5899,617,3297,430,2602,329,4638,552,2597,366,2041,295,380,201,198,122,182,111,434,241,273,189,161,94,422,248,204,148,218,142,25,37,25,37,0,17
14000US08035014504,"Census Tract 145.04, Douglas, CO",4624,433,1919,197,2705,346,4042,394,1650,185,2392,319,240,141,115,73,125,98,139,76,62,41,77,51,203,95,92,59,111,60,0,12,0,12,0,12
14000US08035014505,"Census Tract 145.05, Douglas, CO",5818,717,2861,396,2957,426,4325,697,2230,408,2095,421,1019,379,398,210,621,199,306,186,164,157,142,98,155,133,56,54,99,91,13,22,13,22,0,17
14000US08035014506,"Census Tract 145.06, Douglas, CO",5652,572,2503,297,3149,340,4492,536,1994,285,2498,303,316,156,147,82,169,83,288,259,130,127,158,139,556,219,232,107,324,139,0,17,0,17,0,17
14000US08035014602,"Census Tract 146.02, Douglas, CO",2375,230,1166,163,1209,111,2151,245,1038,155,1113,127,134,88,82,68,52,41,50,45,16,16,34,31,40,34,30,28,10,11,0,12,0,12,0,12
14000US08035014603,"Census Tract 146.03, Douglas, CO",7163,1377,3753,762,3410,688,6191,1450,3149,778,3042,735,639,454,406,295,233,167,144,119,79,63,65,62,109,101,39,44,70,64,80,61,80,61,0,17
14000US08035014604,"Census Tract 146.04, Douglas, CO",3932,394,1863,225,2069,231,3412,367,1626,222,1786,208,162,98,69,45,93,58,229,234,112,118,117,117,121,83,48,36,73,52,8,12,8,12,0,12
14000US08037000100,"Census Tract 1, Eagle, CO",1556,370,864,229,692,203,1440,371,793,221,647,205,0,12,0,12,0,12,65,79,42,56,23,27,51,42,29,29,22,23,0,12,0,12,0,12
14000US08037000200,"Census Tract 2, Eagle, CO",7097,98,3498,455,3599,448,5719,697,2811,479,2908,563,659,513,405,338,254,239,519,489,125,136,394,369,200,163,157,145,43,41,0,17,0,17,0,17
14000US08037000301,"Census Tract 3.01, Eagle, CO",6499,759,3948,620,2551,384,5414,708,3177,505,2237,338,271,174,245,146,26,46,315,255,215,213,100,104,362,331,174,215,188,162,137,174,137,174,0,17
14000US08037000302,"Census Tract 3.02, Eagle, CO",2698,563,1404,379,1294,274,2333,551,1241,377,1092,266,5,8,0,12,5,8,290,165,122,76,168,136,32,45,10,15,22,32,38,53,31,43,7,11
14000US08037000401,"Census Tract 4.01, Eagle, CO",4022,669,1976,384,2046,416,3749,670,1849,382,1900,419,91,107,55,69,36,41,182,138,72,90,110,75,0,12,0,12,0,12,0,12,0,12,0,12
14000US08037000402,"Census Tract 4.02, Eagle, CO",5111,724,2952,503,2159,398,4423,644,2540,433,1883,364,359,207,198,129,161,122,43,47,35,43,8,14,171,119,64,53,107,81,115,149,115,149,0,17
14000US08037000501,"Census Tract 5.01, Eagle, CO",1113,328,646,243,467,136,766,245,352,125,414,130,22,36,10,17,12,20,0,12,0,12,0,12,294,207,253,199,41,39,31,50,31,50,0,12
14000US08037000502,"Census Tract 5.02, Eagle, CO",4788,624,2502,532,2286,406,3546,506,1655,354,1891,349,457,332,313,244,144,142,442,308,311,207,131,151,260,149,204,162,56,50,83,113,19,31,64,109
14000US08037000600,"Census Tract 6, Eagle, CO",1464,325,724,186,740,186,1181,289,571,166,610,167,132,83,82,47,50,53,77,56,43,30,34,32,61,52,21,32,40,40,13,15,7,8,6,8
14000US08037000701,"Census Tract 7.01, Eagle, CO",1867,361,1023,265,844,185,1318,322,747,227,571,169,259,193,68,76,191,141,141,112,127,109,14,19,126,60,81,45,45,44,23,34,0,12,23,34
14000US08037000702,"Census Tract 7.02, Eagle, CO",1413,249,660,148,753,150,1205,231,548,132,657,134,88,52,37,32,51,40,41,32,28,22,13,15,31,31,22,26,9,16,48,42,25,32,23,18
14000US08037000703,"Census Tract 7.03, Eagle, CO",2609,359,1438,242,1171,203,2301,361,1292,236,1009,201,96,92,27,29,69,71,131,88,52,52,79,56,43,57,41,55,2,5,38,49,26,48,12,18
14000US08039961100,"Census Tract 9611, Elbert, CO",2153,331,1134,172,1019,196,1816,262,1027,173,789,118,92,82,21,18,71,77,244,127,86,41,158,111,1,4,0,12,1,4,0,12,0,12,0,12
14000US08039961204,"Census Tract 9612.04, Elbert, CO",7876,739,4015,406,3861,439,6902,748,3544,433,3358,413,88,110,66,80,22,33,812,360,387,150,425,242,55,53,18,30,37,41,19,31,0,17,19,31
14000US08039961205,"Census Tract 9612.05, Elbert, CO",2125,267,1115,131,1010,166,1910,271,995,137,915,167,28,32,11,12,17,21,174,101,103,65,71,42,13,13,6,7,7,9,0,12,0,12,0,12
14000US08039961206,"Census Tract 9612.06, Elbert, CO",3595,435,1720,261,1875,245,3002,375,1440,203,1562,238,41,55,0,12,41,55,446,287,248,205,198,124,67,87,19,31,48,59,39,39,13,20,26,33
14000US08039961207,"Census Tract 9612.07, Elbert, CO",4178,496,2143,267,2035,307,3668,529,1875,283,1793,313,76,57,51,51,25,23,356,207,180,95,176,125,78,55,37,33,41,31,0,12,0,12,0,12
14000US08039961208,"Census Tract 9612.08, Elbert, CO",4013,347,1929,214,2084,233,3466,336,1650,190,1816,218,28,35,28,35,0,12,438,190,204,135,234,111,81,103,47,61,34,44,0,12,0,12,0,12
14000US08039961209,"Census Tract 9612.09, Elbert, CO",2069,231,1059,132,1010,144,1852,230,947,129,905,143,59,39,23,18,36,37,130,69,66,44,64,36,28,34,23,33,5,7,0,12,0,12,0,12
14000US08041000102,"Census Tract 1.02, El Paso, CO",3512,503,1654,250,1858,312,2937,401,1336,194,1601,267,445,373,222,173,223,207,64,54,58,50,6,11,66,69,38,37,28,39,0,12,0,12,0,12
14000US08041000202,"Census Tract 2.02, El Paso, CO",4345,475,2324,302,2021,263,3568,475,1875,278,1693,256,518,151,320,118,198,73,68,54,33,33,35,43,170,90,75,58,95,57,21,23,21,23,0,12
14000US08041000203,"Census Tract 2.03, El Paso, CO",4356,742,1990,277,2366,738,3268,594,1551,248,1717,568,633,223,282,117,351,180,188,170,54,63,134,155,239,99,83,53,156,87,28,34,20,24,8,13
14000US08041000301,"Census Tract 3.01, El Paso, CO",3606,626,1757,345,1849,385,2551,396,1155,257,1396,247,423,218,297,177,126,69,41,36,27,27,14,23,574,519,261,218,313,305,17,26,17,26,0,12
14000US08041000302,"Census Tract 3.02, El Paso, CO",4757,562,2538,407,2219,314,3368,625,1762,374,1606,325,635,210,396,140,239,109,434,244,243,151,191,167,299,190,129,79,170,136,21,26,8,17,13,20
14000US08041000400,"Census Tract 4, El Paso, CO",2287,284,1086,170,1201,197,1943,266,906,164,1037,175,225,110,129,63,96,63,12,28,0,12,12,28,107,84,51,49,56,40,0,12,0,12,0,12
14000US08041000500,"Census Tract 5, El Paso, CO",1966,390,960,212,1006,234,1618,378,751,201,867,212,175,97,119,82,56,41,24,37,12,19,12,18,149,130,78,58,71,78,0,12,0,12,0,12
14000US08041000600,"Census Tract 6, El Paso, CO",2939,382,1406,212,1533,219,2516,362,1144,199,1372,210,259,136,142,75,117,69,97,65,66,38,31,42,67,54,54,52,13,14,0,12,0,12,0,12
14000US08041000700,"Census Tract 7, El Paso, CO",3233,504,1625,337,1608,252,2792,482,1353,296,1439,248,289,132,151,87,138,72,57,47,36,43,21,24,95,101,85,97,10,16,0,12,0,12,0,12
14000US08041000800,"Census Tract 8, El Paso, CO",2835,360,1512,269,1323,159,2271,305,1206,252,1065,127,423,237,243,164,180,97,40,39,39,38,1,4,64,56,2,4,62,57,37,36,22,29,15,22
14000US08041000900,"Census Tract 9, El Paso, CO",2440,369,1209,218,1231,209,1809,371,953,225,856,177,429,232,200,120,229,122,68,62,6,10,62,61,114,63,38,27,76,47,20,42,12,25,8,17
14000US08041001000,"Census Tract 10, El Paso, CO",2222,339,1104,191,1118,198,1899,357,931,190,968,199,171,105,67,55,104,62,78,62,50,52,28,29,74,65,56,60,18,21,0,12,0,12,0,12
14000US08041001101,"Census Tract 11.01, El Paso, CO",1471,425,905,365,566,110,1111,423,699,362,412,123,267,132,130,85,137,61,72,60,64,57,8,11,21,17,12,15,9,10,0,12,0,12,0,12
14000US08041001104,"Census Tract 11.04, El Paso, CO",3079,365,1621,301,1458,225,2367,348,1252,278,1115,203,424,193,265,142,159,90,152,191,54,87,98,110,136,86,50,38,86,63,0,12,0,12,0,12
14000US08041001301,"Census Tract 13.01, El Paso, CO",1777,273,962,148,815,200,1527,239,871,152,656,164,143,77,28,36,115,57,40,34,9,10,31,33,67,57,54,49,13,16,0,12,0,12,0,12
14000US08041001302,"Census Tract 13.02, El Paso, CO",5555,731,2825,507,2730,336,4483,741,2112,501,2371,348,393,206,241,137,152,107,238,156,172,111,66,72,421,301,280,198,141,125,20,32,20,32,0,17
14000US08041001400,"Census Tract 14, El Paso, CO",3225,340,1675,207,1550,226,2479,299,1268,170,1211,194,598,273,349,177,249,135,60,57,31,35,29,36,88,66,27,28,61,42,0,12,0,12,0,12
14000US08041001500,"Census Tract 15, El Paso, CO",2163,358,1043,251,1120,186,1764,275,837,195,927,138,297,154,145,107,152,84,32,45,32,45,0,12,51,64,10,17,41,62,19,29,19,29,0,12
14000US08041001600,"Census Tract 16, El Paso, CO",3366,412,1676,251,1690,249,1283,236,647,111,636,193,1024,252,463,140,561,153,294,100,123,70,171,72,654,189,373,127,281,137,111,65,70,52,41,38
14000US08041001700,"Census Tract 17, El Paso, CO",1932,250,937,153,995,151,1353,178,645,108,708,110,425,164,216,102,209,89,40,29,18,17,22,19,108,61,52,38,56,38,6,9,6,9,0,12
14000US08041001800,"Census Tract 18, El Paso, CO",1951,242,1095,184,856,121,1666,233,932,178,734,113,224,90,130,65,94,39,22,19,16,17,6,9,39,35,17,16,22,22,0,12,0,12,0,12
14000US08041002000,"Census Tract 20, El Paso, CO",6709,690,3379,508,3330,385,5037,628,2452,435,2585,381,1465,552,779,364,686,299,75,75,60,72,15,23,114,103,70,61,44,55,18,28,18,28,0,17
14000US08041002101,"Census Tract 21.01, El Paso, CO",3944,499,2050,314,1894,289,2535,435,1255,274,1280,255,851,302,513,179,338,152,151,126,52,60,99,78,407,236,230,137,177,110,0,12,0,12,0,12
14000US08041002102,"Census Tract 21.02, El Paso, CO",4726,561,2163,329,2563,376,3965,594,1780,329,2185,363,491,218,288,145,203,120,92,80,47,56,45,46,112,74,48,33,64,52,66,80,0,12,66,80
14000US08041002200,"Census Tract 22, El Paso, CO",3062,420,1444,247,1618,269,2025,340,965,215,1060,205,684,245,308,131,376,139,44,44,14,33,30,28,242,151,114,90,128,90,67,84,43,48,24,38
14000US08041002300,"Census Tract 23, El Paso, CO",2009,380,1130,231,879,212,1217,210,621,138,596,143,532,248,302,130,230,154,128,103,123,102,5,7,114,72,79,56,35,29,18,23,5,13,13,19
14000US08041002501,"Census Tract 25.01, El Paso, CO",3645,613,1781,289,1864,357,3240,619,1535,291,1705,359,307,160,172,95,135,75,0,12,0,12,0,12,98,73,74,58,24,22,0,12,0,12,0,12
14000US08041002502,"Census Tract 25.02, El Paso, CO",4127,409,2082,247,2045,305,2995,400,1488,225,1507,284,619,223,313,148,306,122,154,104,108,77,46,43,304,141,147,85,157,84,55,56,26,30,29,33
14000US08041002700,"Census Tract 27, El Paso, CO",3196,344,1560,264,1636,199,2793,346,1344,263,1449,189,237,123,102,61,135,74,66,71,66,71,0,12,77,78,25,31,52,72,23,37,23,37,0,12
14000US08041003100,"Census Tract 31, El Paso, CO",4417,467,2044,239,2373,271,3745,459,1691,233,2054,269,378,247,219,161,159,89,42,34,3,7,39,33,230,148,121,79,109,77,22,24,10,15,12,18
14000US08041003303,"Census Tract 33.03, El Paso, CO",5084,542,2377,417,2707,343,3792,599,1716,380,2076,374,837,454,453,273,384,250,40,41,29,29,11,17,394,247,158,122,236,160,21,34,21,34,0,17
14000US08041003305,"Census Tract 33.05, El Paso, CO",7999,1036,4043,609,3956,554,6394,1020,3208,539,3186,589,260,140,165,95,95,72,505,401,276,230,229,175,685,388,326,189,359,213,155,154,68,74,87,88
14000US08041003306,"Census Tract 33.06, El Paso, CO",3324,545,1670,334,1654,307,3114,527,1562,317,1552,300,138,103,84,75,54,43,59,70,21,32,38,44,13,19,3,8,10,13,0,12,0,12,0,12
14000US08041003307,"Census Tract 33.07, El Paso, CO",3421,472,1740,280,1681,244,2519,385,1207,215,1312,204,414,234,256,136,158,111,78,54,30,25,48,43,367,195,211,128,156,80,43,42,36,41,7,11
14000US08041003308,"Census Tract 33.08, El Paso, CO",5590,614,2462,389,3128,436,3668,774,1652,380,2016,517,867,369,305,159,562,298,199,183,97,91,102,99,635,285,310,165,325,166,221,185,98,106,123,132
14000US08041003702,"Census Tract 37.02, El Paso, CO",4705,350,2261,213,2444,218,3864,403,1863,209,2001,240,558,291,238,144,320,171,54,71,44,69,10,15,229,118,116,74,113,52,0,12,0,12,0,12
14000US08041003705,"Census Tract 37.05, El Paso, CO",6854,1077,3383,752,3471,482,5529,1092,2806,726,2723,512,744,348,337,192,407,233,39,61,0,17,39,61,542,256,240,132,302,148,0,17,0,17,0,17
14000US08041003706,"Census Tract 37.06, El Paso, CO",4770,505,2298,339,2472,336,3563,367,1680,212,1883,230,675,296,364,223,311,130,257,164,69,76,188,128,249,144,159,99,90,58,26,36,26,36,0,12
14000US08041003707,"Census Tract 37.07, El Paso, CO",2810,202,1606,157,1204,138,2427,262,1397,175,1030,146,185,94,106,70,79,47,54,66,33,35,21,32,128,87,54,34,74,56,16,18,16,18,0,12
14000US08041003708,"Census Tract 37.08, El Paso, CO",2961,320,1396,179,1565,222,2344,329,1100,178,1244,217,357,162,161,82,196,106,0,12,0,12,0,12,228,127,127,64,101,76,32,33,8,14,24,23
14000US08041003801,"Census Tract 38.01, El Paso, CO",2149,434,1101,205,1048,282,1533,403,740,178,793,260,305,173,212,138,93,74,0,12,0,12,0,12,221,95,100,50,121,55,90,72,49,39,41,47
14000US08041003802,"Census Tract 38.02, El Paso, CO",4167,410,2954,364,1213,267,3339,386,2396,316,943,221,156,90,103,81,53,54,0,12,0,12,0,12,649,190,432,152,217,106,23,49,23,49,0,12
14000US08041003905,"Census Tract 39.05, El Paso, CO",4142,484,2060,285,2082,328,2862,391,1497,210,1365,244,630,211,332,118,298,171,27,30,0,12,27,30,604,302,212,132,392,204,19,32,19,32,0,12
14000US08041003906,"Census Tract 39.06, El Paso, CO",5881,665,2705,408,3176,404,4916,714,2315,406,2601,400,340,203,114,87,226,145,144,168,73,93,71,82,470,229,192,115,278,174,11,18,11,18,0,17
14000US08041004008,"Census Tract 40.08, El Paso, CO",2883,396,1687,271,1196,197,1640,418,949,267,691,194,221,142,143,91,78,58,11,15,3,8,8,13,824,286,459,152,365,159,187,157,133,110,54,55
14000US08041004009,"Census Tract 40.09, El Paso, CO",1707,271,957,194,750,129,987,250,550,156,437,117,467,210,288,138,179,98,80,49,41,30,39,29,162,89,78,41,84,60,11,14,0,12,11,14
14000US08041004100,"Census Tract 41, El Paso, CO",4909,957,2672,715,2237,333,4651,954,2518,708,2133,327,140,104,70,58,70,63,8,14,8,14,0,12,71,76,56,71,15,17,39,68,20,34,19,34
14000US08041004200,"Census Tract 42, El Paso, CO",3687,487,1884,303,1803,260,3025,397,1548,233,1477,235,576,301,298,191,278,124,20,20,10,15,10,15,66,50,28,23,38,32,0,12,0,12,0,12
14000US08041004300,"Census Tract 43, El Paso, CO",6767,849,3015,507,3752,488,5719,834,2457,454,3262,519,214,143,130,99,84,81,118,131,69,121,49,54,716,385,359,233,357,181,0,17,0,17,0,17
14000US08041004402,"Census Tract 44.02, El Paso, CO",6045,624,5455,635,590,166,2667,488,2395,493,272,106,324,98,301,93,23,27,71,59,71,59,0,17,1876,246,1629,217,247,110,1107,319,1059,318,48,38
14000US08041004403,"Census Tract 44.03, El Paso, CO",1391,325,796,164,595,192,927,301,486,139,441,187,63,57,48,48,15,19,8,13,4,9,4,9,283,137,156,68,127,81,110,48,102,46,8,8
14000US08041004501,"Census Tract 45.01, El Paso, CO",4548,444,2479,367,2069,248,3457,498,1785,367,1672,225,582,272,434,186,148,142,323,268,181,121,142,188,173,203,66,80,107,127,13,20,13,20,0,12
14000US08041004502,"Census Tract 45.02, El Paso, CO",6471,664,3391,386,3080,379,5174,663,2703,375,2471,360,504,220,193,97,311,165,71,80,31,35,40,49,642,300,399,233,243,121,80,72,65,64,15,21
14000US08041004506,"Census Tract 45.06, El Paso, CO",6537,1165,3322,539,3215,741,5675,1179,2874,520,2801,751,418,226,174,103,244,140,164,123,129,97,35,55,267,150,132,87,135,87,13,20,13,20,0,17
14000US08041004507,"Census Tract 45.07, El Paso, CO",2928,431,1286,232,1642,317,2363,391,1087,192,1276,281,193,120,51,35,142,109,259,337,89,108,170,230,75,104,21,29,54,78,38,49,38,49,0,12
14000US08041004601,"Census Tract 46.01, El Paso, CO",4297,627,2151,370,2146,306,4023,594,1995,344,2028,299,219,158,121,101,98,64,20,21,9,13,11,16,34,34,26,24,8,17,1,3,0,12,1,3
14000US08041004602,"Census Tract 46.02, El Paso, CO",4980,852,2196,242,2784,778,4349,833,1900,233,2449,764,424,242,180,96,244,178,75,51,40,30,35,25,122,100,66,62,56,43,10,14,10,14,0,17
14000US08041004603,"Census Tract 46.03, El Paso, CO",8300,1323,4331,823,3969,628,6362,1152,3386,739,2976,478,661,380,284,141,377,304,338,472,119,178,219,295,886,590,489,394,397,217,53,64,53,64,0,17
14000US08041004701,"Census Tract 47.01, El Paso, CO",4897,530,2512,404,2385,238,4209,427,1999,226,2210,253,552,378,457,353,95,77,25,28,8,13,17,21,82,82,36,50,46,42,29,35,12,19,17,19
14000US08041004702,"Census Tract 47.02, El Paso, CO",2128,334,1112,207,1016,163,1809,307,899,176,910,158,137,61,84,47,53,30,30,24,16,14,14,15,88,71,77,69,11,12,64,95,36,54,28,42
14000US08041004703,"Census Tract 47.03, El Paso, CO",5542,508,2798,360,2744,313,4818,541,2460,355,2358,333,354,244,179,166,175,133,114,159,58,81,56,79,231,186,76,62,155,130,25,39,25,39,0,17
14000US08041004706,"Census Tract 47.06, El Paso, CO",5900,639,2942,359,2958,400,4744,684,2342,364,2402,404,665,259,358,146,307,145,61,70,19,29,42,50,370,212,163,105,207,123,60,50,60,50,0,17
14000US08041004800,"Census Tract 48, El Paso, CO",4819,615,2590,428,2229,286,3749,629,2055,420,1694,279,536,248,256,110,280,160,268,185,175,111,93,79,266,179,104,93,162,111,0,12,0,12,0,12
14000US08041004901,"Census Tract 49.01, El Paso, CO",3643,421,1832,243,1811,284,2753,343,1336,201,1417,243,671,241,384,152,287,124,33,31,23,27,10,16,186,168,89,81,97,98,0,12,0,12,0,12
14000US08041004902,"Census Tract 49.02, El Paso, CO",5154,665,2759,493,2395,222,4371,717,2352,511,2019,251,484,217,237,113,247,121,21,24,14,20,7,13,248,202,126,105,122,99,30,39,30,39,0,17
14000US08041005000,"Census Tract 50, El Paso, CO",5523,768,2987,508,2536,356,3963,762,2254,506,1709,329,768,345,355,164,413,236,101,72,49,39,52,51,552,208,270,136,282,120,139,208,59,90,80,118
14000US08041005110,"Census Tract 51.10, El Paso, CO",4066,476,2010,313,2056,273,3430,433,1636,249,1794,270,357,246,251,190,106,70,118,80,50,48,68,50,161,109,73,37,88,96,0,12,0,12,0,12
14000US08041005201,"Census Tract 52.01, El Paso, CO",4405,698,2408,489,1997,376,3088,691,1757,451,1331,317,887,413,421,226,466,239,34,36,13,17,21,32,396,268,217,158,179,148,0,12,0,12,0,12
14000US08041005202,"Census Tract 52.02, El Paso, CO",3216,642,1398,235,1818,501,2273,580,980,221,1293,424,722,309,252,125,470,260,51,57,51,57,0,12,108,82,53,51,55,48,62,68,62,68,0,12
14000US08041005300,"Census Tract 53, El Paso, CO",4806,759,2122,466,2684,506,3668,724,1773,393,1895,442,808,262,178,114,630,255,176,129,42,39,134,116,138,108,113,91,25,35,16,26,16,26,0,12
14000US08041005400,"Census Tract 54, El Paso, CO",5891,1054,2765,531,3126,636,4466,1001,1971,528,2495,563,787,349,357,178,430,222,16,31,9,16,7,15,622,473,428,308,194,188,0,17,0,17,0,17
14000US08041005501,"Census Tract 55.01, El Paso, CO",6610,906,3514,609,3096,422,5483,910,2965,598,2518,396,658,229,284,121,374,147,96,83,61,75,35,33,325,159,184,112,141,73,48,61,20,30,28,33
14000US08041005502,"Census Tract 55.02, El Paso, CO",4678,967,2442,583,2236,478,3198,846,1634,559,1564,352,1162,551,604,271,558,325,30,33,30,33,0,12,108,70,82,60,26,37,180,253,92,130,88,124
14000US08041005601,"Census Tract 56.01, El Paso, CO",3736,592,1893,393,1843,321,3150,616,1547,374,1603,332,370,315,211,233,159,117,46,57,28,38,18,33,170,224,107,133,63,92,0,12,0,12,0,12
14000US08041005602,"Census Tract 56.02, El Paso, CO",3264,432,1635,214,1629,281,2704,473,1342,238,1362,283,357,159,206,107,151,75,100,98,47,54,53,48,76,63,20,29,56,38,27,33,20,30,7,13
14000US08041005700,"Census Tract 57, El Paso, CO",6253,749,3173,521,3080,433,5374,780,2728,506,2646,465,394,273,169,142,225,149,59,79,0,17,59,79,227,145,142,125,85,83,199,294,134,199,65,97
14000US08041005800,"Census Tract 58, El Paso, CO",3125,416,1446,288,1679,209,2500,308,1184,223,1316,172,441,206,149,86,292,146,13,19,13,19,0,12,165,130,94,110,71,64,6,11,6,11,0,12
14000US08041005900,"Census Tract 59, El Paso, CO",7320,740,3653,521,3667,409,5620,524,2820,401,2800,321,924,396,477,207,447,243,231,203,45,66,186,159,498,351,311,238,187,129,47,52,0,17,47,52
14000US08041006000,"Census Tract 60, El Paso, CO",7121,957,3949,678,3172,574,5268,972,2790,622,2478,523,1019,362,612,345,407,200,212,168,183,152,29,35,574,341,316,223,258,171,48,61,48,61,0,17
14000US08041006100,"Census Tract 61, El Paso, CO",4419,652,2213,353,2206,391,2363,587,1185,285,1178,346,1233,352,650,209,583,207,115,75,38,41,77,44,568,261,285,121,283,160,140,136,55,52,85,87
14000US08041006200,"Census Tract 62, El Paso, CO",5209,716,2748,412,2461,420,4103,706,2109,399,1994,407,747,253,405,151,342,131,100,80,63,66,37,30,203,95,124,69,79,54,56,68,47,63,9,15
14000US08041006301,"Census Tract 63.01, El Paso, CO",5094,610,2454,359,2640,395,4551,586,2163,350,2388,376,264,138,144,78,120,79,41,56,37,56,4,9,230,166,102,81,128,91,8,15,8,15,0,17
14000US08041006302,"Census Tract 63.02, El Paso, CO",6010,905,2863,538,3147,528,3829,750,1904,458,1925,435,1739,854,752,382,987,519,107,130,62,78,45,53,323,191,133,99,190,148,12,18,12,18,0,17
14000US08041006400,"Census Tract 64, El Paso, CO",7217,1171,3705,681,3512,604,6331,1199,3198,671,3133,622,449,258,192,117,257,178,139,170,95,122,44,54,235,144,157,122,78,61,63,70,63,70,0,17
14000US08041006501,"Census Tract 65.01, El Paso, CO",3791,766,1915,367,1876,499,3213,759,1586,349,1627,503,406,265,253,178,153,111,49,71,27,39,22,32,103,98,49,43,54,62,20,27,0,12,20,27
14000US08041006502,"Census Tract 65.02, El Paso, CO",7773,1029,3895,621,3878,585,6705,926,3241,601,3464,509,649,467,448,311,201,181,93,128,0,17,93,128,326,221,206,145,120,100,0,17,0,17,0,17
14000US08041006600,"Census Tract 66, El Paso, CO",2403,408,1288,371,1115,147,1849,200,857,111,992,133,384,367,316,358,68,58,96,92,65,62,31,39,74,55,50,49,24,18,0,12,0,12,0,12
14000US08041006801,"Census Tract 68.01, El Paso, CO",4121,518,1947,272,2174,365,3544,536,1626,282,1918,347,498,238,266,116,232,165,29,45,15,24,14,21,50,59,40,58,10,16,0,12,0,12,0,12
14000US08041006802,"Census Tract 68.02, El Paso, CO",3831,513,1930,313,1901,285,2903,383,1522,270,1381,164,408,218,216,130,192,121,51,53,20,22,31,34,469,390,172,112,297,285,0,12,0,12,0,12
14000US08041006901,"Census Tract 69.01, El Paso, CO",4793,483,2385,288,2408,260,4305,467,2187,298,2118,234,195,135,97,75,98,71,105,78,33,30,72,69,160,109,59,40,101,75,28,48,9,16,19,32
14000US08041006902,"Census Tract 69.02, El Paso, CO",5547,789,2625,382,2922,556,4148,454,2077,285,2071,273,708,489,259,240,449,446,140,76,54,31,86,70,545,382,235,167,310,226,6,11,0,17,6,11
14000US08041007000,"Census Tract 70, El Paso, CO",4513,633,2299,327,2214,343,3964,570,2043,282,1921,316,261,239,132,130,129,112,99,120,72,116,27,30,189,127,52,47,137,99,0,12,0,12,0,12
14000US08041007602,"Census Tract 76.02, El Paso, CO",3243,275,1660,211,1583,142,2796,319,1483,231,1313,146,318,169,115,64,203,109,82,74,38,34,44,47,47,64,24,29,23,37,0,12,0,12,0,12
14000US08041007700,"Census Tract 77, El Paso, CO",6203,1055,3297,716,2906,475,5043,1067,2755,688,2288,467,512,278,240,152,272,161,155,200,59,73,96,127,456,306,226,193,230,173,37,46,17,28,20,34
14000US08041007900,"Census Tract 79, El Paso, CO",2933,351,1338,218,1595,237,2700,352,1257,218,1443,226,149,93,51,49,98,62,25,38,0,12,25,38,50,48,30,28,20,22,9,14,0,12,9,14
14000US08041008000,"Census Tract 80, El Paso, CO",4474,551,2258,382,2216,273,3231,533,1766,366,1465,252,933,292,344,144,589,218,79,74,67,65,12,18,219,147,69,63,150,105,12,18,12,18,0,12
14000US08043978100,"Census Tract 9781, Fremont, CO",3626,500,1631,233,1995,338,3079,462,1398,221,1681,313,224,160,113,84,111,81,244,153,102,72,142,91,79,80,18,21,61,61,0,12,0,12,0,12
14000US08043978200,"Census Tract 9782, Fremont, CO",3615,189,1797,192,1818,197,3227,277,1599,220,1628,209,235,164,124,93,111,78,107,72,57,46,50,46,46,55,17,16,29,43,0,12,0,12,0,12
14000US08043978300,"Census Tract 9783, Fremont, CO",5602,577,2605,321,2997,403,4464,540,2117,301,2347,374,595,387,213,154,382,262,376,251,202,133,174,132,167,125,73,69,94,68,0,17,0,17,0,17
14000US08043978400,"Census Tract 9784, Fremont, CO",2462,317,1396,239,1066,150,1986,230,1061,161,925,139,362,254,270,218,92,58,53,48,36,34,17,19,61,48,29,25,32,29,0,12,0,12,0,12
14000US08043978500,"Census Tract 9785, Fremont, CO",5369,559,2292,272,3077,381,4943,585,2149,289,2794,391,142,87,26,28,116,79,49,49,28,31,21,20,235,187,89,77,146,116,0,17,0,17,0,17
14000US08043978600,"Census Tract 9786, Fremont, CO",3725,421,1719,241,2006,309,3311,472,1512,233,1799,337,196,154,99,94,97,78,100,87,54,57,46,53,118,83,54,47,64,58,0,12,0,12,0,12
14000US08043978800,"Census Tract 9788, Fremont, CO",2154,308,969,128,1185,231,1809,296,836,120,973,212,156,100,50,52,106,67,126,107,39,38,87,81,57,65,38,38,19,30,6,14,6,14,0,12
14000US08043979100,"Census Tract 9791, Fremont, CO",3215,336,1471,200,1744,209,2724,296,1315,179,1409,184,217,126,51,40,166,109,143,127,68,66,75,66,89,60,33,26,56,38,42,61,4,7,38,55
14000US08043979200,"Census Tract 9792, Fremont, CO",1700,250,944,169,756,121,1629,245,902,164,727,121,21,25,21,25,0,12,29,34,15,21,14,15,21,22,6,10,15,14,0,12,0,12,0,12
14000US08043979400,"Census Tract 9794, Fremont, CO",3047,394,1928,330,1119,132,2594,304,1552,230,1042,132,188,119,150,111,38,26,55,71,45,70,10,10,199,104,170,95,29,22,11,13,11,13,0,12
14000US08043980100,"Census Tract 9801, Fremont, CO",274,123,274,123,0,12,274,123,274,123,0,12,0,12,0,12,0,12,0,12,0,12,0,12,0,12,0,12,0,12,0,12,0,12,0,12
14000US08043980200,"Census Tract 9802, Fremont, CO",3067,798,3041,798,26,52,2348,723,2322,732,26,52,292,186,292,186,0,12,184,173,184,173,0,12,163,131,163,131,0,12,80,117,80,117,0,12
14000US08043980300,"Census Tract 9803, Fremont, CO",5778,572,5636,566,142,116,5753,575,5636,566,117,131,12,25,0,17,12,25,13,25,0,17,13,25,0,17,0,17,0,17,0,17,0,17,0,17
14000US08045951600,"Census Tract 9516, Garfield, CO",3973,591,1627,301,2346,408,3669,591,1571,311,2098,387,232,200,46,43,186,174,23,38,0,12,23,38,20,32,10,16,10,16,29,42,0,12,29,42
14000US08045951701,"Census Tract 9517.01, Garfield, CO",4732,529,2543,321,2189,301,4105,564,2210,332,1895,319,177,133,111,81,66,62,237,157,127,83,110,90,213,182,95,84,118,110,0,12,0,12,0,12
14000US08045951702,"Census Tract 9517.02, Garfield, CO",3053,376,1648,296,1405,219,2489,325,1383,266,1106,197,322,163,188,124,134,87,163,93,63,35,100,71,79,61,14,20,65,57,0,12,0,12,0,12
14000US08045951802,"Census Tract 9518.02, Garfield, CO",4349,636,1958,367,2391,402,4131,637,1808,349,2323,414,134,117,95,89,39,41,52,66,31,37,21,32,17,20,17,20,0,12,15,24,7,11,8,13
14000US08045951803,"Census Tract 9518.03, Garfield, CO",5703,407,3054,407,2649,344,4689,452,2461,394,2228,333,426,275,228,170,198,120,218,127,157,98,61,57,245,190,83,81,162,142,125,137,125,137,0,17
14000US08045951804,"Census Tract 9518.04, Garfield, CO",4707,604,2354,408,2353,318,3817,409,1843,257,1974,273,467,403,322,313,145,119,330,176,126,95,204,113,80,63,50,43,30,27,13,25,13,25,0,12
14000US08045951901,"Census Tract 9519.01, Garfield, CO",5122,531,2559,383,2563,299,4527,556,2280,379,2247,316,400,174,171,98,229,107,74,44,49,38,25,22,115,112,59,52,56,66,6,10,0,17,6,10
14000US08045951902,"Census Tract 9519.02, Garfield, CO",6764,389,3462,355,3302,257,5568,492,2689,370,2879,257,709,321,409,187,300,182,287,221,225,145,62,98,116,102,108,103,8,15,84,91,31,50,53,53
14000US08045952001,"Census Tract 9520.01, Garfield, CO",5113,559,2402,301,2711,380,4547,612,2205,300,2342,408,534,318,190,124,344,272,22,36,7,12,15,25,0,17,0,17,0,17,10,23,0,17,10,23
14000US08045952100,"Census Tract 9521, Garfield, CO",6968,785,3906,530,3062,412,5588,618,3143,422,2445,350,655,273,351,160,304,147,478,256,265,157,213,119,247,215,147,124,100,94,0,17,0,17,0,17
14000US08049000100,"Census Tract 1, Grand, CO",3521,496,1927,345,1594,281,3133,465,1741,336,1392,262,197,138,115,107,82,88,95,96,38,40,57,67,96,89,33,37,63,58,0,12,0,12,0,12
14000US08051963800,"Census Tract 9638, Gunnison, CO",4645,477,2576,291,2069,256,3952,480,2230,285,1722,266,380,188,200,100,180,102,136,91,55,48,81,62,78,70,41,38,37,37,99,119,50,60,49,61
14000US08051963900,"Census Tract 9639, Gunnison, CO",1110,228,628,175,482,102,864,202,500,159,364,91,103,103,69,66,34,40,84,42,26,16,58,34,59,34,33,22,26,23,0,12,0,12,0,12
14000US08053973100,"Census Tract 9731, Hinsdale, CO",772,138,319,64,453,99,697,130,291,60,406,95,6,9,3,5,3,5,35,25,12,10,23,18,34,27,13,11,21,20,0,12,0,12,0,12
14000US08055960600,"Census Tract 9606, Huerfano, CO",3146,120,1641,147,1505,132,2831,185,1465,186,1366,131,202,121,105,97,97,86,87,111,64,92,23,29,26,33,7,10,19,33,0,12,0,12,0,12
14000US08057955600,"Census Tract 9556, Jackson, CO",1316,164,678,113,638,105,1086,185,573,109,513,111,179,118,76,49,103,81,48,40,27,23,21,18,3,5,2,3,1,2,0,12,0,12,0,12
14000US08059009806,"Census Tract 98.06, Jefferson, CO",4121,433,1897,226,2224,260,3588,393,1668,213,1920,233,140,85,62,64,78,50,68,51,25,29,43,38,292,134,133,64,159,81,33,36,9,13,24,30
14000US08059009807,"Census Tract 98.07, Jefferson, CO",1865,336,922,146,943,274,1526,284,701,90,825,268,96,69,62,54,34,28,222,174,146,124,76,53,21,20,13,14,8,11,0,12,0,12,0,12
14000US08059009815,"Census Tract 98.15, Jefferson, CO",5362,519,2743,301,2619,278,4665,513,2337,278,2328,288,403,233,218,136,185,110,228,125,177,110,51,37,45,47,11,23,34,32,21,25,0,17,21,25
14000US08059009823,"Census Tract 98.23, Jefferson, CO",4776,442,2486,384,2290,215,4044,385,2018,257,2026,207,422,289,275,278,147,106,247,149,161,115,86,67,63,50,32,29,31,28,0,12,0,12,0,12
14000US08059009824,"Census Tract 98.24, Jefferson, CO",4670,584,2272,269,2398,451,4227,599,2011,265,2216,456,215,171,139,94,76,87,165,88,86,48,79,58,63,50,36,37,27,25,0,12,0,12,0,12
14000US08059009827,"Census Tract 98.27, Jefferson, CO",6092,671,2953,363,3139,465,5060,642,2568,380,2492,369,262,150,46,44,216,121,412,339,98,68,314,323,358,332,241,205,117,150,0,17,0,17,0,17
14000US08059009828,"Census Tract 98.28, Jefferson, CO",5791,629,3110,438,2681,356,5281,658,2850,442,2431,355,50,50,9,22,41,40,272,233,106,95,166,143,188,195,145,160,43,59,0,17,0,17,0,17
14000US08059009829,"Census Tract 98.29, Jefferson, CO",1913,240,989,126,924,149,1798,242,933,130,865,146,14,21,14,21,0,12,101,53,42,26,59,32,0,12,0,12,0,12,0,12,0,12,0,12
14000US08059009830,"Census Tract 98.30, Jefferson, CO",2303,260,1106,134,1197,183,2035,263,982,129,1053,198,122,82,45,42,77,59,60,40,47,31,13,15,86,66,32,36,54,54,0,12,0,12,0,12
14000US08059009831,"Census Tract 98.31, Jefferson, CO",2537,366,1263,223,1274,246,1361,257,705,132,656,184,272,151,128,89,144,110,600,276,300,157,300,146,304,185,130,89,174,114,0,12,0,12,0,12
14000US08059009832,"Census Tract 98.32, Jefferson, CO",2396,226,1361,164,1035,108,2012,194,1104,116,908,114,165,85,89,66,76,38,165,86,114,74,51,30,54,51,54,51,0,12,0,12,0,12,0,12
14000US08059009833,"Census Tract 98.33, Jefferson, CO",5527,697,2579,491,2948,358,4900,591,2174,386,2726,336,82,65,57,56,25,29,439,389,311,277,128,120,106,122,37,40,69,86,0,17,0,17,0,17
14000US08059009834,"Census Tract 98.34, Jefferson, CO",4334,441,2215,287,2119,275,3412,377,1712,234,1700,221,434,276,209,113,225,193,302,138,191,97,111,61,186,119,103,92,83,67,0,12,0,12,0,12
14000US08059009835,"Census Tract 98.35, Jefferson, CO",3671,430,1759,218,1912,257,3338,425,1579,213,1759,258,144,186,85,123,59,66,149,93,74,49,75,51,29,27,10,15,19,22,11,17,11,17,0,12
14000US08059009836,"Census Tract 98.36, Jefferson, CO",4054,480,2026,337,2028,260,3777,463,1840,312,1937,257,122,87,65,52,57,43,136,119,102,92,34,46,19,22,19,22,0,12,0,12,0,12,0,12
14000US08059009837,"Census Tract 98.37, Jefferson, CO",7574,946,3711,538,3863,514,6050,992,2905,530,3145,532,806,317,430,170,376,176,285,205,141,128,144,92,398,245,235,144,163,114,35,46,0,17,35,46
14000US08059009838,"Census Tract 98.38, Jefferson, CO",4721,340,2268,259,2453,208,4307,354,2037,244,2270,221,146,103,85,68,61,39,131,100,83,62,48,40,98,80,54,45,44,39,39,58,9,14,30,44
14000US08059009839,"Census Tract 98.39, Jefferson, CO",2278,264,1269,160,1009,139,2152,279,1207,168,945,143,74,52,33,26,41,30,16,18,10,11,6,9,36,27,19,20,17,17,0,12,0,12,0,12
14000US08059009840,"Census Tract 98.40, Jefferson, CO",3318,345,1504,217,1814,192,2918,336,1287,194,1631,193,218,133,122,95,96,50,143,83,85,54,58,43,39,38,10,16,29,27,0,12,0,12,0,12
14000US08059009841,"Census Tract 98.41, Jefferson, CO",1952,170,1045,98,907,116,1669,214,884,123,785,119,152,109,71,55,81,59,106,78,82,65,24,28,23,24,6,9,17,17,2,7,2,7,0,12
14000US08059009842,"Census Tract 98.42, Jefferson, CO",3198,351,1573,169,1625,272,3065,340,1497,146,1568,269,39,40,18,25,21,25,39,38,39,38,0,12,46,62,15,18,31,46,9,16,4,8,5,9
14000US08059009845,"Census Tract 98.45, Jefferson, CO",4394,621,2168,348,2226,339,3846,594,1985,346,1861,300,194,112,87,65,107,73,295,229,73,50,222,184,52,42,16,18,36,29,7,12,7,12,0,12
14000US08059009846,"Census Tract 98.46, Jefferson, CO",4846,494,2412,311,2434,261,4213,503,2039,306,2174,266,404,196,243,126,161,81,159,104,99,78,60,31,70,56,31,36,39,30,0,12,0,12,0,12
14000US08059009847,"Census Tract 98.47, Jefferson, CO",3562,484,1685,263,1877,353,3158,459,1496,216,1662,361,195,175,115,89,80,91,130,92,51,55,79,59,79,63,23,34,56,52,0,12,0,12,0,12
14000US08059009848,"Census Tract 98.48, Jefferson, CO",2565,264,1285,151,1280,171,2326,242,1192,148,1134,150,86,67,34,27,52,47,49,42,25,32,24,28,94,49,29,26,65,36,10,16,5,8,5,9
14000US08059009850,"Census Tract 98.50, Jefferson, CO",2328,284,1148,208,1180,142,2014,288,970,189,1044,157,126,108,64,69,62,49,56,58,56,58,0,12,132,86,58,44,74,47,0,12,0,12,0,12
14000US08059009851,"Census Tract 98.51, Jefferson, CO",4240,606,1977,353,2263,310,3931,589,1841,348,2090,297,173,121,67,55,106,70,96,65,55,47,41,42,40,51,14,23,26,31,0,12,0,12,0,12
14000US08059009852,"Census Tract 98.52, Jefferson, CO",4503,650,2310,346,2193,354,4113,653,2097,334,2016,354,142,89,63,52,79,53,223,105,150,93,73,41,25,23,0,12,25,23,0,12,0,12,0,12
14000US08059010100,"Census Tract 101, Jefferson, CO",5738,1017,2726,464,3012,763,4916,1054,2255,449,2661,783,346,137,217,122,129,75,208,130,166,125,42,51,268,162,88,67,180,112,0,17,0,17,0,17
14000US08059010205,"Census Tract 102.05, Jefferson, CO",2516,291,1328,203,1188,129,2405,288,1269,200,1136,130,72,51,35,27,37,27,15,15,15,15,0,12,18,18,9,9,9,13,6,8,0,12,6,8
14000US08059010206,"Census Tract 102.06, Jefferson, CO",3737,396,1757,203,1980,267,3214,415,1535,208,1679,263,285,120,103,51,182,85,148,113,54,33,94,86,79,67,65,70,14,16,11,17,0,12,11,17
14000US08059010208,"Census Tract 102.08, Jefferson, CO",5892,685,2765,418,3127,441,5123,741,2524,422,2599,437,280,145,178,103,102,82,441,283,63,53,378,256,48,70,0,17,48,70,0,17,0,17,0,17
14000US08059010209,"Census Tract 102.09, Jefferson, CO",7711,1023,3408,480,4303,765,6631,1151,2772,432,3859,815,511,439,328,344,183,117,361,218,187,128,174,117,127,134,67,93,60,59,81,90,54,57,27,43
14000US08059010210,"Census Tract 102.10, Jefferson, CO",3554,306,1807,187,1747,188,3029,344,1597,201,1432,201,327,147,107,61,220,95,104,71,79,53,25,24,54,50,15,20,39,46,40,44,9,15,31,36
14000US08059010211,"Census Tract 102.11, Jefferson, CO",3258,537,1414,188,1844,418,2744,513,1172,171,1572,407,336,183,166,106,170,96,155,65,62,33,93,48,13,24,4,7,9,17,10,16,10,16,0,12
14000US08059010212,"Census Tract 102.12, Jefferson, CO",3989,511,2119,301,1870,328,3385,518,1801,297,1584,299,339,214,180,123,159,132,211,130,101,62,110,77,47,38,37,38,10,16,7,14,0,12,7,14
14000US08059010213,"Census Tract 102.13, Jefferson, CO",4584,468,2392,348,2192,225,3921,355,1956,227,1965,211,375,252,286,207,89,75,116,78,45,30,71,63,172,159,105,100,67,64,0,12,0,12,0,12
14000US08059010303,"Census Tract 103.03, Jefferson, CO",5771,925,2820,582,2951,428,4780,688,2291,385,2489,391,695,372,391,305,304,176,219,183,96,114,123,102,77,89,42,53,35,41,0,17,0,17,0,17
14000US08059010304,"Census Tract 103.04, Jefferson, CO",2420,181,1252,155,1168,126,2036,245,1055,176,981,136,177,134,100,73,77,81,121,70,71,45,50,36,86,61,26,32,60,42,0,12,0,12,0,12
14000US08059010305,"Census Tract 103.05, Jefferson, CO",3676,582,1963,368,1713,314,3041,576,1650,356,1391,289,167,141,96,93,71,80,385,220,201,119,184,136,83,60,16,18,67,51,0,12,0,12,0,12
14000US08059010306,"Census Tract 103.06, Jefferson, CO",3092,522,1609,304,1483,293,2883,519,1508,311,1375,278,48,52,32,48,16,21,126,142,48,51,78,96,35,36,21,33,14,18,0,12,0,12,0,12
14000US08059010307,"Census Tract 103.07, Jefferson, CO",4518,553,2282,329,2236,367,3878,529,1947,317,1931,347,303,213,135,105,168,117,314,259,177,140,137,130,23,36,23,36,0,12,0,12,0,12,0,12
14000US08059010308,"Census Tract 103.08, Jefferson, CO",5545,606,2698,399,2847,355,4686,604,2255,385,2431,366,477,276,235,138,242,151,280,217,159,128,121,109,102,91,49,46,53,50,0,17,0,17,0,17
14000US08059010402,"Census Tract 104.02, Jefferson, CO",5504,890,2147,348,3357,673,4137,486,1675,242,2462,372,454,188,169,86,285,146,791,672,225,245,566,453,77,62,33,37,44,41,45,54,45,54,0,17
14000US08059010403,"Census Tract 104.03, Jefferson, CO",5474,650,2849,497,2625,382,4697,629,2405,459,2292,377,278,224,122,100,156,152,248,235,156,148,92,98,238,270,153,145,85,136,13,21,13,21,0,17
14000US08059010405,"Census Tract 104.05, Jefferson, CO",2637,351,1244,169,1393,294,1718,291,791,167,927,210,291,138,103,75,188,104,400,157,197,72,203,113,218,101,143,78,75,47,10,16,10,16,0,12
14000US08059010406,"Census Tract 104.06, Jefferson, CO",2778,505,1400,205,1378,369,2418,522,1179,215,1239,365,175,106,111,63,64,56,92,53,38,41,54,33,88,59,67,47,21,20,5,12,5,12,0,12
14000US08059010502,"Census Tract 105.02, Jefferson, CO",5228,658,2709,371,2519,394,4552,679,2390,377,2162,380,353,234,136,136,217,118,161,121,109,87,52,67,162,129,74,61,88,122,0,17,0,17,0,17
14000US08059010503,"Census Tract 105.03, Jefferson, CO",4567,520,1806,229,2761,391,3855,552,1517,236,2338,395,372,162,155,84,217,112,214,107,94,54,120,82,90,64,20,24,70,50,36,56,20,36,16,23
14000US08059010504,"Census Tract 105.04, Jefferson, CO",3098,450,1686,314,1412,187,2872,411,1568,292,1304,174,29,48,19,32,10,16,147,204,69,99,78,105,27,31,19,28,8,13,23,37,11,18,12,19
14000US08059010603,"Census Tract 106.03, Jefferson, CO",3424,382,1561,264,1863,239,2933,376,1289,220,1644,247,256,163,175,137,81,51,110,49,58,30,52,28,110,82,38,37,72,51,15,20,1,4,14,20
14000US08059010604,"Census Tract 106.04, Jefferson, CO",2373,424,1108,230,1265,222,1953,395,917,212,1036,213,273,154,144,78,129,91,112,54,27,27,85,47,35,30,20,22,15,15,0,12,0,12,0,12
14000US08059010701,"Census Tract 107.01, Jefferson, CO",5103,663,2260,523,2843,422,4196,597,1968,433,2228,324,369,276,77,94,292,262,377,171,123,90,254,123,143,151,92,141,51,46,18,27,0,17,18,27
14000US08059010702,"Census Tract 107.02, Jefferson, CO",5082,641,2560,363,2522,499,3481,688,1657,366,1824,420,558,304,441,280,117,94,563,420,208,151,355,289,470,276,244,169,226,169,10,17,10,17,0,17
14000US08059010801,"Census Tract 108.01, Jefferson, CO",2576,317,1243,173,1333,200,2290,306,1134,169,1156,185,189,177,89,79,100,105,47,38,9,14,38,29,50,49,11,16,39,38,0,12,0,12,0,12
14000US08059010901,"Census Tract 109.01, Jefferson, CO",5157,663,2565,392,2592,489,4158,767,2030,427,2128,464,347,264,180,135,167,197,356,311,223,180,133,142,296,233,132,94,164,159,0,17,0,17,0,17
14000US08059010902,"Census Tract 109.02, Jefferson, CO",2491,414,1167,285,1324,216,1805,416,865,241,940,225,339,243,143,94,196,166,322,236,153,137,169,143,25,42,6,10,19,32,0,12,0,12,0,12
14000US08059011000,"Census Tract 110, Jefferson, CO",5726,1075,2923,654,2803,491,4807,1052,2296,628,2511,483,549,275,416,227,133,107,293,116,151,74,142,77,77,89,60,86,17,25,0,17,0,17,0,17
14000US08059011202,"Census Tract 112.02, Jefferson, CO",4915,932,2341,569,2574,424,4379,932,2121,576,2258,414,176,75,41,27,135,64,213,92,75,40,138,70,125,71,94,57,31,22,22,24,10,12,12,20
14000US08059011300,"Census Tract 113, Jefferson, CO",3173,459,1557,272,1616,264,2823,451,1352,239,1471,273,72,44,53,33,19,19,272,131,152,84,120,70,6,9,0,12,6,9,0,12,0,12,0,12
14000US08059011401,"Census Tract 114.01, Jefferson, CO",2300,354,1058,212,1242,223,1649,270,714,170,935,176,261,205,178,152,83,68,338,155,132,82,206,102,52,45,34,28,18,21,0,12,0,12,0,12
14000US08059011402,"Census Tract 114.02, Jefferson, CO",4644,669,2477,357,2167,479,3260,492,1798,321,1462,265,576,280,398,180,178,127,773,416,254,105,519,385,7,11,7,11,0,12,28,43,20,30,8,13
14000US08059011601,"Census Tract 116.01, Jefferson, CO",4038,690,1914,369,2124,396,3349,727,1627,393,1722,417,192,142,46,50,146,127,321,238,149,116,172,134,166,227,92,112,74,117,10,18,0,12,10,18
14000US08059011602,"Census Tract 116.02, Jefferson, CO",4106,486,2163,360,1943,243,3743,525,1991,373,1752,256,78,44,49,32,29,23,149,126,70,73,79,63,103,142,38,67,65,78,33,46,15,22,18,25
14000US08059011701,"Census Tract 117.01, Jefferson, CO",4525,495,1995,326,2530,274,3992,446,1706,262,2286,272,124,63,58,37,66,44,321,286,176,175,145,118,88,85,55,56,33,37,0,12,0,12,0,12
14000US08059011702,"Census Tract 117.02, Jefferson, CO",5429,739,2812,533,2617,342,4755,653,2429,443,2326,329,318,163,116,71,202,127,179,106,133,109,46,42,81,90,38,43,43,47,96,153,96,153,0,17
14000US08059011708,"Census Tract 117.08, Jefferson, CO",3999,339,2096,258,1903,166,3350,310,1764,221,1586,167,276,129,161,92,115,72,242,110,95,60,147,94,131,157,76,89,55,70,0,12,0,12,0,12
14000US08059011709,"Census Tract 117.09, Jefferson, CO",3450,392,1815,252,1635,247,3093,425,1650,269,1443,253,144,67,72,42,72,37,114,64,52,37,62,46,54,43,34,36,20,16,45,52,7,12,38,47
14000US08059011710,"Census Tract 117.10, Jefferson, CO",4011,477,2069,296,1942,307,3481,480,1725,285,1756,295,168,122,71,51,97,107,301,167,256,162,45,36,56,45,17,21,39,48,5,10,0,12,5,10
14000US08059011711,"Census Tract 117.11, Jefferson, CO",4417,630,2152,345,2265,361,3699,616,1749,325,1950,345,361,128,198,102,163,64,104,72,50,42,54,44,253,179,155,140,98,83,0,12,0,12,0,12
14000US08059011712,"Census Tract 117.12, Jefferson, CO",3983,364,1848,182,2135,261,3782,335,1776,168,2006,251,143,158,65,83,78,79,45,38,7,11,38,33,13,21,0,12,13,21,0,12,0,12,0,12
14000US08059011720,"Census Tract 117.20, Jefferson, CO",5004,867,2323,446,2681,481,4178,470,1953,292,2225,265,143,142,62,68,81,83,129,90,54,51,75,77,554,790,254,381,300,411,0,17,0,17,0,17
14000US08059011721,"Census Tract 117.21, Jefferson, CO",2571,348,1179,201,1392,220,2153,292,1016,188,1137,166,247,171,89,70,158,111,45,48,29,33,16,17,126,91,45,34,81,81,0,12,0,12,0,12
14000US08059011723,"Census Tract 117.23, Jefferson, CO",3791,598,1788,301,2003,359,3006,635,1433,308,1573,375,334,183,136,80,198,127,254,145,114,79,140,75,190,138,105,85,85,67,7,12,0,12,7,12
14000US08059011724,"Census Tract 117.24, Jefferson, CO",7277,785,3407,425,3870,425,6091,688,2950,396,3141,352,433,151,167,61,266,114,574,293,222,108,352,194,172,142,68,54,104,94,7,13,0,17,7,13
14000US08059011725,"Census Tract 117.25, Jefferson, CO",1884,288,1020,161,864,171,1692,290,920,165,772,166,51,51,33,33,18,19,98,146,36,48,62,98,43,31,31,24,12,14,0,12,0,12,0,12
14000US08059011726,"Census Tract 117.26, Jefferson, CO",5451,535,2816,334,2635,280,5181,517,2606,316,2575,284,76,64,34,37,42,42,68,75,53,73,15,23,44,67,41,64,3,9,82,125,82,125,0,17
14000US08059011727,"Census Tract 117.27, Jefferson, CO",3619,444,1925,304,1694,205,3311,398,1742,283,1569,190,147,118,75,57,72,65,140,119,99,98,41,42,21,23,9,13,12,18,0,12,0,12,0,12
14000US08059011728,"Census Tract 117.28, Jefferson, CO",2828,353,1411,180,1417,219,2521,331,1240,168,1281,204,112,68,70,43,42,37,140,128,82,88,58,50,21,25,8,14,13,20,34,32,11,17,23,27
14000US08059011729,"Census Tract 117.29, Jefferson, CO",4258,626,1797,329,2461,465,3425,596,1456,315,1969,457,351,187,189,119,162,82,324,153,113,61,211,106,139,81,20,26,119,71,19,29,19,29,0,12
14000US08059011730,"Census Tract 117.30, Jefferson, CO",3280,449,1669,260,1611,272,2516,393,1254,198,1262,252,289,149,123,86,166,86,323,185,226,151,97,78,138,78,66,36,72,58,14,21,0,12,14,21
14000US08059011731,"Census Tract 117.31, Jefferson, CO",4264,583,1943,315,2321,346,3735,520,1624,270,2111,321,245,143,137,82,108,78,205,199,123,119,82,82,79,55,59,39,20,22,0,12,0,12,0,12
14000US08059011732,"Census Tract 117.32, Jefferson, CO",4539,598,2321,440,2218,317,3142,603,1575,436,1567,299,703,361,417,265,286,139,348,160,173,93,175,91,282,150,124,77,158,94,64,104,32,51,32,53
14000US08059011733,"Census Tract 117.33, Jefferson, CO",1735,276,791,173,944,148,1425,288,692,173,733,159,212,122,72,52,140,79,73,55,18,17,55,52,25,30,9,14,16,17,0,12,0,12,0,12
14000US08059011803,"Census Tract 118.03, Jefferson, CO",6043,963,3251,667,2792,571,5365,990,2894,665,2471,572,366,257,164,90,202,191,142,89,60,44,82,57,170,106,133,110,37,29,0,17,0,17,0,17
14000US08059011804,"Census Tract 118.04, Jefferson, CO",4280,396,1947,268,2333,349,3661,382,1696,258,1965,273,327,155,128,75,199,114,186,100,104,64,82,55,106,66,19,31,87,54,0,12,0,12,0,12
14000US08059011806,"Census Tract 118.06, Jefferson, CO",5289,609,2560,388,2729,397,4592,628,2182,372,2410,404,300,129,128,79,172,89,207,153,139,118,68,53,134,183,77,130,57,62,56,86,34,53,22,34
14000US08059011904,"Census Tract 119.04, Jefferson, CO",2779,405,1411,327,1368,193,2248,378,1092,277,1156,215,173,118,117,81,56,49,247,131,110,72,137,75,111,75,92,68,19,22,0,12,0,12,0,12
14000US08059011951,"Census Tract 119.51, Jefferson, CO",3322,339,1593,195,1729,226,2705,362,1323,215,1382,210,214,167,107,80,107,96,378,271,147,82,231,201,25,30,16,18,9,14,0,12,0,12,0,12
14000US08059012022,"Census Tract 120.22, Jefferson, CO",5743,810,2855,601,2888,369,5133,866,2608,606,2525,402,266,243,103,95,163,162,208,246,56,66,152,183,136,126,88,76,48,58,0,17,0,17,0,17
14000US08059012023,"Census Tract 120.23, Jefferson, CO",3275,277,1609,207,1666,175,2656,246,1216,182,1440,168,387,245,240,186,147,99,153,148,103,88,50,65,79,54,50,44,29,23,0,12,0,12,0,12
14000US08059012024,"Census Tract 120.24, Jefferson, CO",5194,541,2405,280,2789,379,4112,490,1927,268,2185,328,329,263,98,72,231,193,376,297,196,143,180,160,321,130,169,71,152,77,56,90,15,24,41,66
14000US08059012026,"Census Tract 120.26, Jefferson, CO",3460,652,1708,348,1752,336,3064,656,1519,341,1545,344,99,75,1,13,98,74,65,67,27,30,38,43,226,119,161,95,65,49,6,10,0,12,6,10
14000US08059012027,"Census Tract 120.27, Jefferson, CO",3024,402,1486,253,1538,221,2871,369,1428,247,1443,194,57,50,42,35,15,31,44,42,16,20,28,26,44,36,0,12,44,36,8,13,0,12,8,13
14000US08059012030,"Census Tract 120.30, Jefferson, CO",3941,445,2084,266,1857,217,3432,432,1831,256,1601,212,103,74,38,28,65,51,79,86,24,37,55,54,280,164,167,100,113,78,47,54,24,31,23,29
14000US08059012031,"Census Tract 120.31, Jefferson, CO",3650,305,1908,207,1742,161,3193,331,1632,219,1561,165,237,137,140,80,97,62,158,95,93,80,65,37,0,12,0,12,0,12,62,65,43,40,19,33
14000US08059012032,"Census Tract 120.32, Jefferson, CO",2853,298,1518,213,1335,145,2534,310,1324,218,1210,142,189,151,103,81,86,73,89,83,57,54,32,31,41,52,34,42,7,10,0,12,0,12,0,12
14000US08059012033,"Census Tract 120.33, Jefferson, CO",2797,607,1410,311,1387,316,2445,439,1267,307,1178,156,200,193,63,52,137,180,84,63,55,41,29,26,68,71,25,32,43,43,0,12,0,12,0,12
14000US08059012034,"Census Tract 120.34, Jefferson, CO",3825,441,1847,237,1978,243,3560,464,1722,243,1838,254,148,99,68,46,80,60,103,88,57,49,46,41,0,12,0,12,0,12,14,21,0,12,14,21
14000US08059012035,"Census Tract 120.35, Jefferson, CO",4974,428,2565,259,2409,277,4668,407,2446,249,2222,277,97,69,54,44,43,37,59,49,17,20,42,32,138,126,48,48,90,93,12,20,0,17,12,20
14000US08059012036,"Census Tract 120.36, Jefferson, CO",3811,196,1709,185,2102,178,3675,230,1635,186,2040,193,68,88,42,64,26,31,18,31,9,15,9,15,50,62,23,28,27,43,0,12,0,12,0,12
14000US08059012037,"Census Tract 120.37, Jefferson, CO",4014,765,2075,471,1939,362,3764,768,1960,467,1804,367,152,95,67,57,85,49,22,33,11,16,11,17,65,75,37,38,28,38,11,17,0,12,11,17
14000US08059012038,"Census Tract 120.38, Jefferson, CO",3658,551,1929,408,1729,190,3244,549,1766,407,1478,180,47,43,12,18,35,40,275,160,110,75,165,101,92,80,41,43,51,55,0,12,0,12,0,12
14000US08059012039,"Census Tract 120.39, Jefferson, CO",5490,573,2837,346,2653,289,4423,428,2285,272,2138,242,541,297,334,193,207,125,301,256,139,129,162,130,141,105,79,93,62,40,84,104,0,17,84,104
14000US08059012041,"Census Tract 120.41, Jefferson, CO",5572,601,2667,303,2905,407,5024,475,2437,296,2587,303,505,441,219,183,286,277,42,42,11,17,31,30,1,5,0,17,1,5,0,17,0,17,0,17
14000US08059012042,"Census Tract 120.42, Jefferson, CO",3986,468,1901,208,2085,327,3699,460,1776,200,1923,321,131,94,66,55,65,54,113,103,30,39,83,76,38,35,29,27,9,13,5,9,0,12,5,9
14000US08059012043,"Census Tract 120.43, Jefferson, CO",6418,1030,3120,579,3298,533,5445,983,2665,585,2780,481,122,83,57,48,65,66,458,195,173,97,285,147,372,289,204,155,168,147,21,34,21,34,0,17
14000US08059012044,"Census Tract 120.44, Jefferson, CO",3555,288,1947,236,1608,150,3040,263,1639,172,1401,155,215,107,89,52,126,65,288,222,213,211,75,46,12,20,6,10,6,10,0,12,0,12,0,12
14000US08059012045,"Census Tract 120.45, Jefferson, CO",5948,600,3072,417,2876,323,4913,450,2418,277,2495,281,531,451,304,308,227,187,380,287,266,200,114,92,76,78,50,50,26,33,48,83,34,58,14,26
14000US08059012046,"Census Tract 120.46, Jefferson, CO",2212,212,1061,129,1151,154,2025,218,979,126,1046,151,96,40,46,26,50,33,71,48,30,25,41,29,20,17,6,10,14,14,0,12,0,12,0,12
14000US08059012047,"Census Tract 120.47, Jefferson, CO",4465,498,2198,309,2267,298,3761,608,1927,335,1834,317,362,214,124,58,238,199,176,107,93,60,83,61,166,165,54,42,112,130,0,12,0,12,0,12
14000US08059012048,"Census Tract 120.48, Jefferson, CO",2187,204,1098,137,1089,118,2059,204,1042,128,1017,125,46,48,38,46,8,13,45,42,18,19,27,25,37,36,0,12,37,36,0,12,0,12,0,12
14000US08059012049,"Census Tract 120.49, Jefferson, CO",4045,538,2064,332,1981,268,3515,603,1788,353,1727,294,308,185,153,102,155,100,169,120,110,92,59,54,41,45,13,19,28,30,12,19,0,12,12,19
14000US08059012050,"Census Tract 120.50, Jefferson, CO",3980,374,2019,329,1961,176,3174,347,1632,299,1542,144,198,126,126,111,72,51,383,124,184,90,199,90,200,107,65,59,135,64,25,41,12,20,13,22
14000US08059012051,"Census Tract 120.51, Jefferson, CO",3868,497,1929,298,1939,280,3713,501,1854,296,1859,283,52,54,23,28,29,27,66,45,28,24,38,33,37,36,24,25,13,14,0,12,0,12,0,12
14000US08059012052,"Census Tract 120.52, Jefferson, CO",5337,718,2698,446,2639,378,4636,570,2329,330,2307,341,426,452,277,302,149,157,224,152,87,71,137,103,51,52,5,18,46,53,0,17,0,17,0,17
14000US08059012053,"Census Tract 120.53, Jefferson, CO",4584,882,2341,531,2243,412,4247,880,2190,528,2057,414,220,193,99,74,121,147,16,18,6,8,10,15,101,59,46,27,55,39,0,12,0,12,0,12
14000US08059012054,"Census Tract 120.54, Jefferson, CO",3635,307,1746,157,1889,207,3399,315,1619,152,1780,218,97,71,47,40,50,37,97,81,63,48,34,35,35,40,17,19,18,20,7,12,0,12,7,12
14000US08059012055,"Census Tract 120.55, Jefferson, CO",3667,314,1966,186,1701,203,3402,337,1802,209,1600,198,36,32,15,22,21,23,138,120,94,86,44,42,67,60,55,59,12,18,24,36,0,12,24,36
14000US08059012057,"Census Tract 120.57, Jefferson, CO",5696,545,2761,354,2935,351,4842,558,2374,378,2468,309,296,191,177,111,119,94,208,140,142,103,66,63,350,311,68,69,282,262,0,17,0,17,0,17
14000US08059012058,"Census Tract 120.58, Jefferson, CO",3704,522,1859,346,1845,236,3354,490,1724,317,1630,212,193,167,86,112,107,83,73,74,33,37,40,38,84,94,16,24,68,90,0,12,0,12,0,12
14000US08059012059,"Census Tract 120.59, Jefferson, CO",3607,472,1809,257,1798,281,3086,490,1526,264,1560,285,188,138,109,86,79,98,138,95,41,36,97,79,184,138,122,100,62,45,11,17,11,17,0,12
14000US08059012060,"Census Tract 120.60, Jefferson, CO",3236,370,1796,282,1440,170,2929,381,1620,284,1309,175,84,52,40,24,44,32,172,137,119,102,53,40,51,51,17,21,34,43,0,12,0,12,0,12
14000US08059015800,"Census Tract 158, Jefferson, CO",4434,623,2314,527,2120,295,2956,399,1386,208,1570,242,667,255,386,242,281,121,588,405,387,375,201,113,223,106,155,79,68,49,0,12,0,12,0,12
14000US08059015900,"Census Tract 159, Jefferson, CO",3618,434,1817,287,1801,307,2883,409,1459,282,1424,266,380,187,150,108,230,128,228,82,143,64,85,48,124,85,65,44,59,61,3,5,0,12,3,5
14000US08059060300,"Census Tract 603, Jefferson, CO",4799,527,2437,276,2362,344,4450,487,2251,255,2199,335,63,44,41,26,22,23,190,134,88,55,102,83,96,83,57,49,39,41,0,12,0,12,0,12
14000US08059060400,"Census Tract 604, Jefferson, CO",3918,556,2174,330,1744,319,3259,423,1801,271,1458,228,141,110,100,100,41,38,455,302,238,169,217,163,51,56,23,26,28,31,12,19,12,19,0,12
14000US08059980000,"Census Tract 9800, Jefferson, CO",0,12,0,12,0,12,0,12,0,12,0,12,0,12,0,12,0,12,0,12,0,12,0,12,0,12,0,12,0,12,0,12,0,12,0,12
14000US08059980400,"Census Tract 9804, Jefferson, CO",1325,369,1325,369,0,12,749,314,749,314,0,12,172,148,172,148,0,12,181,178,181,178,0,12,208,144,208,144,0,12,15,29,15,29,0,12
14000US08061960100,"Census Tract 9601, Kiowa, CO",1436,163,683,98,753,109,1126,159,556,99,570,86,125,96,51,48,74,55,143,70,65,31,78,55,39,30,11,12,28,22,3,4,0,12,3,4
14000US08063962100,"Census Tract 9621, Kit Carson, CO",4637,241,2391,141,2246,167,3997,272,2082,185,1915,167,111,81,78,52,33,41,221,104,90,53,131,73,252,177,120,96,132,90,56,52,21,24,35,45
14000US08065961900,"Census Tract 9619, Lake, CO",2126,354,1234,255,892,189,1960,343,1138,248,822,184,32,50,7,12,25,39,77,58,38,28,39,40,57,46,51,43,6,10,0,12,0,12,0,12
14000US08067940300,"Census Tract 9403, La Plata, CO",6168,540,3119,305,3049,307,5858,533,2951,300,2907,307,131,56,87,45,44,23,79,55,30,24,49,38,96,54,47,33,49,36,4,6,4,6,0,17
14000US08067940400,"Census Tract 9404, La Plata, CO",5973,440,3075,264,2898,246,5364,358,2785,221,2579,197,303,104,126,46,177,76,123,62,68,44,55,29,168,63,90,45,78,33,15,21,6,10,9,12
14000US08067970701,"Census Tract 9707.01, La Plata, CO",5195,613,2584,321,2611,384,4979,631,2494,323,2485,401,130,99,24,28,106,90,16,25,8,12,8,12,60,54,58,54,2,3,10,17,0,17,10,17
14000US08067970703,"Census Tract 9707.03, La Plata, CO",6497,833,3037,429,3460,577,5034,788,2293,445,2741,545,368,184,216,137,152,88,427,339,139,143,288,209,668,299,389,215,279,146,0,17,0,17,0,17
14000US08067970800,"Census Tract 9708, La Plata, CO",6603,520,3090,421,3513,312,4941,588,2345,421,2596,335,515,245,184,109,331,192,487,292,187,120,300,189,610,165,353,121,257,92,50,40,21,23,29,40
14000US08067970900,"Census Tract 9709, La Plata, CO",4442,474,2216,337,2226,311,3874,480,1941,324,1933,311,358,166,150,94,208,112,86,76,57,63,29,32,124,87,68,50,56,49,0,12,0,12,0,12
14000US08067971000,"Census Tract 9710, La Plata, CO",3523,575,1829,346,1694,301,2954,551,1484,311,1470,307,362,163,270,110,92,77,101,67,55,51,46,44,106,68,20,23,86,64,0,12,0,12,0,12
14000US08067971100,"Census Tract 9711, La Plata, CO",4408,471,2260,316,2148,297,3701,449,1858,316,1843,289,294,209,203,160,91,75,114,70,82,61,32,38,299,222,117,104,182,141,0,12,0,12,0,12
14000US08069000100,"Census Tract 1, Larimer, CO",2893,325,1347,255,1546,255,1769,274,943,218,826,151,717,221,215,95,502,199,135,102,81,80,54,49,159,96,77,64,82,51,113,117,31,50,82,78
14000US08069000201,"Census Tract 2.01, Larimer, CO",2571,278,1266,236,1305,247,1526,171,739,136,787,148,538,181,310,153,228,98,287,135,111,74,176,112,207,89,106,57,101,70,13,20,0,12,13,20
14000US08069000202,"Census Tract 2.02, Larimer, CO",2470,422,1208,255,1262,234,1887,279,920,159,967,199,90,48,32,27,58,37,139,122,73,92,66,46,337,304,174,177,163,140,17,26,9,13,8,13
14000US08069000300,"Census Tract 3, Larimer, CO",2729,348,1506,261,1223,177,2573,336,1391,239,1182,173,78,59,64,53,14,17,55,58,38,45,17,20,23,26,13,15,10,15,0,12,0,12,0,12
14000US08069000401,"Census Tract 4.01, Larimer, CO",2033,335,1036,171,997,216,1518,332,774,164,744,200,331,124,161,70,170,74,99,73,59,45,40,36,80,55,42,38,38,27,5,8,0,12,5,8
14000US08069000402,"Census Tract 4.02, Larimer, CO",2274,397,1146,303,1128,187,1595,430,842,276,753,191,277,177,140,98,137,101,151,148,58,94,93,119,251,121,106,64,145,81,0,12,0,12,0,12
14000US08069000503,"Census Tract 5.03, Larimer, CO",7341,1439,2929,706,4412,1249,3222,731,1391,383,1831,538,2373,1103,856,375,1517,1060,917,267,315,184,602,257,622,265,203,188,419,211,207,201,164,195,43,42
14000US08069000504,"Census Tract 5.04, Larimer, CO",2950,445,1782,397,1168,272,2154,468,1229,384,925,240,491,175,327,140,164,123,146,105,137,102,9,15,153,83,83,54,70,67,6,9,6,9,0,12
14000US08069000505,"Census Tract 5.05, Larimer, CO",3703,366,1716,266,1987,361,2608,404,1208,249,1400,351,657,160,290,134,367,123,292,130,147,77,145,80,146,78,71,48,75,50,0,12,0,12,0,12
14000US08069000506,"Census Tract 5.06, Larimer, CO",3086,372,1713,284,1373,217,2117,327,1172,249,945,170,756,256,426,183,330,130,79,84,65,81,14,23,111,76,41,32,70,64,23,27,9,15,14,23
14000US08069000600,"Census Tract 6, Larimer, CO",6903,686,3264,436,3639,376,1376,313,653,179,723,189,1101,288,546,191,555,169,2675,370,1254,202,1421,253,1613,308,713,211,900,182,138,78,98,59,40,36
14000US08069000700,"Census Tract 7, Larimer, CO",2575,328,1461,245,1114,203,1990,297,1166,239,824,152,367,189,177,91,190,149,60,43,21,18,39,32,142,85,81,65,61,43,16,32,16,32,0,12
14000US08069000801,"Census Tract 8.01, Larimer, CO",1592,214,758,112,834,133,1279,178,592,97,687,112,179,74,100,48,79,51,44,24,25,19,19,18,67,42,31,22,36,29,23,28,10,13,13,16
14000US08069000802,"Census Tract 8.02, Larimer, CO",1233,219,596,130,637,136,911,223,434,125,477,140,136,58,51,33,85,41,63,73,24,27,39,47,123,61,87,45,36,31,0,12,0,12,0,12
14000US08069000901,"Census Tract 9.01, Larimer, CO",5635,522,2684,363,2951,436,4248,497,1890,227,2358,488,743,358,487,285,256,160,451,211,211,105,240,154,193,113,96,73,97,71,0,17,0,17,0,17
14000US08069000902,"Census Tract 9.02, Larimer, CO",4350,654,2204,341,2146,388,2968,502,1533,277,1435,280,441,179,217,118,224,135,309,189,126,87,183,128,577,290,312,177,265,169,55,62,16,27,39,43
14000US08069001003,"Census Tract 10.03, Larimer, CO",5026,572,2513,344,2513,365,3457,459,1725,259,1732,308,918,434,466,259,452,231,209,135,125,90,84,72,442,225,197,111,245,126,0,17,0,17,0,17
14000US08069001004,"Census Tract 10.04, Larimer, CO",3596,408,1730,207,1866,277,3284,422,1530,195,1754,274,135,92,111,79,24,22,87,56,56,43,31,28,68,53,33,28,35,43,22,31,0,12,22,31
14000US08069001007,"Census Tract 10.07, Larimer, CO",3109,310,1535,184,1574,193,2141,241,1060,172,1081,141,547,226,281,147,266,97,144,76,63,51,81,68,269,118,131,69,138,66,8,14,0,12,8,14
14000US08069001008,"Census Tract 10.08, Larimer, CO",1921,254,1025,189,896,119,1452,148,763,116,689,96,264,209,117,120,147,105,107,73,76,52,31,28,98,49,69,36,29,21,0,12,0,12,0,12
14000US08069001009,"Census Tract 10.09, Larimer, CO",6398,695,3108,368,3290,464,5562,737,2782,360,2780,484,451,235,137,88,314,175,188,125,101,97,87,84,197,131,88,88,109,77,0,17,0,17,0,17
14000US08069001010,"Census Tract 10.10, Larimer, CO",2640,287,1316,168,1324,185,2294,276,1146,152,1148,179,268,125,151,75,117,58,0,12,0,12,0,12,67,59,8,13,59,56,11,17,11,17,0,12
14000US08069001104,"Census Tract 11.04, Larimer, CO",6195,859,3501,650,2694,440,5398,825,3158,651,2240,388,437,234,189,107,248,158,204,143,110,116,94,62,156,100,44,39,112,81,0,17,0,17,0,17
14000US08069001106,"Census Tract 11.06, Larimer, CO",4767,572,2505,432,2262,477,4118,464,2124,401,1994,364,447,242,236,143,211,167,82,125,82,125,0,12,120,115,63,72,57,61,0,12,0,12,0,12
14000US08069001107,"Census Tract 11.07, Larimer, CO",5107,534,2401,379,2706,384,3644,596,1887,381,1757,340,997,355,240,119,757,326,289,155,178,109,111,83,135,158,54,66,81,99,42,70,42,70,0,17
14000US08069001109,"Census Tract 11.09, Larimer, CO",5420,741,2522,431,2898,410,4480,715,2094,414,2386,390,386,170,196,84,190,103,200,147,60,51,140,110,306,153,145,94,161,91,48,65,27,34,21,33
14000US08069001110,"Census Tract 11.10, Larimer, CO",4959,617,2478,384,2481,387,3127,423,1451,239,1676,295,829,286,512,203,317,143,452,382,204,189,248,231,528,242,311,147,217,142,23,36,0,12,23,36
14000US08069001111,"Census Tract 11.11, Larimer, CO",2197,368,987,276,1210,280,1407,278,715,231,692,155,402,185,101,64,301,157,210,106,105,52,105,89,119,74,53,47,66,49,59,56,13,15,46,54
14000US08069001112,"Census Tract 11.12, Larimer, CO",4566,415,2226,279,2340,254,4189,390,2036,268,2153,239,212,134,91,61,121,87,39,45,25,27,14,22,126,96,74,75,52,41,0,12,0,12,0,12
14000US08069001113,"Census Tract 11.13, Larimer, CO",3554,368,1790,224,1764,209,3230,330,1601,200,1629,192,147,86,74,55,73,54,97,93,68,76,29,34,80,67,47,36,33,37,0,12,0,12,0,12
14000US08069001114,"Census Tract 11.14, Larimer, CO",2237,306,1214,248,1023,106,1930,285,1047,234,883,103,225,140,124,96,101,49,43,47,23,24,20,24,32,24,20,16,12,11,7,10,0,12,7,10
14000US08069001301,"Census Tract 13.01, Larimer, CO",3566,426,1835,257,1731,235,3379,430,1747,257,1632,234,79,60,45,44,34,34,73,114,20,31,53,83,31,34,19,23,12,19,4,9,4,9,0,12
14000US08069001304,"Census Tract 13.04, Larimer, CO",3345,786,1875,522,1470,405,3105,764,1746,499,1359,394,127,98,81,70,46,54,0,12,0,12,0,12,17,21,17,21,0,12,96,107,31,48,65,99
14000US08069001305,"Census Tract 13.05, Larimer, CO",3013,406,1297,233,1716,488,1927,273,965,230,962,209,612,299,220,106,392,250,232,161,70,68,162,156,235,130,42,40,193,113,7,9,0,12,7,9
14000US08069001306,"Census Tract 13.06, Larimer, CO",2990,312,1597,238,1393,269,2354,358,1124,205,1230,271,262,125,153,93,109,57,241,169,203,161,38,38,133,104,117,88,16,23,0,12,0,12,0,12
14000US08069001307,"Census Tract 13.07, Larimer, CO",4571,538,2163,347,2408,280,3886,539,1760,340,2126,284,395,284,235,173,160,124,135,148,93,121,42,32,144,136,75,59,69,85,11,16,0,12,11,16
14000US08069001308,"Census Tract 13.08, Larimer, CO",5769,811,3089,525,2680,323,5246,806,2803,511,2443,334,336,163,153,79,183,101,118,131,71,77,47,58,46,48,46,48,0,17,23,38,16,26,7,12
14000US08069001601,"Census Tract 16.01, Larimer, CO",2088,579,996,284,1092,324,1948,592,917,291,1031,327,76,38,37,22,39,23,43,55,29,40,14,17,16,25,8,13,8,12,5,8,5,8,0,12
14000US08069001602,"Census Tract 16.02, Larimer, CO",5404,505,2724,331,2680,327,3981,629,2027,359,1954,335,783,392,484,287,299,154,287,236,117,93,170,161,353,303,96,77,257,231,0,17,0,17,0,17
14000US08069001603,"Census Tract 16.03, Larimer, CO",5123,437,2699,318,2424,282,4300,452,2330,327,1970,228,637,287,234,127,403,204,24,29,24,29,0,17,162,98,111,81,51,43,0,17,0,17,0,17
14000US08069001605,"Census Tract 16.05, Larimer, CO",6557,872,3563,530,2994,469,4067,559,2103,311,1964,317,1443,583,874,356,569,279,615,219,370,150,245,138,418,176,202,79,216,117,14,29,14,29,0,17
14000US08069001606,"Census Tract 16.06, Larimer, CO",3654,375,1806,211,1848,261,2553,410,1308,218,1245,242,732,275,325,147,407,181,14,21,0,12,14,21,316,264,154,105,162,169,39,58,19,28,20,31
14000US08069001607,"Census Tract 16.07, Larimer, CO",3924,445,1806,167,2118,391,3361,377,1601,170,1760,281,394,269,94,53,300,256,75,53,65,46,10,16,94,77,46,48,48,40,0,12,0,12,0,12
14000US08069001608,"Census Tract 16.08, Larimer, CO",6496,637,3160,323,3336,441,5741,632,2790,316,2951,433,450,205,226,118,224,110,103,97,41,40,62,59,146,110,82,65,64,51,56,64,21,34,35,35
14000US08069001706,"Census Tract 17.06, Larimer, CO",6668,596,3302,349,3366,388,6096,718,3029,423,3067,419,285,164,125,94,160,111,208,257,103,133,105,126,45,56,28,50,17,28,34,57,17,28,17,29
14000US08069001707,"Census Tract 17.07, Larimer, CO",5335,580,2549,330,2786,404,4201,557,2115,325,2086,330,349,278,80,64,269,241,459,379,272,237,187,152,326,245,82,79,244,192,0,17,0,17,0,17
14000US08069001708,"Census Tract 17.08, Larimer, CO",4876,546,2497,498,2379,250,3782,505,1775,303,2007,301,818,498,572,466,246,149,122,71,52,43,70,49,137,90,98,70,39,39,17,27,0,12,17,27
14000US08069001804,"Census Tract 18.04, Larimer, CO",4441,925,2127,491,2314,505,3824,948,1844,477,1980,496,478,236,192,100,286,247,31,33,16,17,15,17,108,100,75,68,33,41,0,12,0,12,0,12
14000US08069001807,"Census Tract 18.07, Larimer, CO",6509,711,2992,332,3517,545,5234,787,2415,348,2819,528,1092,602,511,326,581,336,62,70,0,17,62,70,121,111,66,76,55,47,0,17,0,17,0,17
14000US08069001808,"Census Tract 18.08, Larimer, CO",5056,650,2372,334,2684,392,4606,599,2172,323,2434,348,144,76,59,45,85,41,156,122,69,56,87,75,150,93,72,55,78,61,0,17,0,17,0,17
14000US08069001901,"Census Tract 19.01, Larimer, CO",4459,688,2426,478,2033,310,3791,672,2098,472,1693,289,352,148,193,84,159,93,237,175,87,77,150,112,79,48,48,28,31,26,0,12,0,12,0,12
14000US08069001902,"Census Tract 19.02, Larimer, CO",4646,526,2348,312,2298,306,4168,519,2049,313,2119,305,332,147,222,99,110,64,83,62,27,26,56,54,63,59,50,44,13,17,0,12,0,12,0,12
14000US08069002005,"Census Tract 20.05, Larimer, CO",5748,619,2945,463,2803,399,4522,562,2358,456,2164,285,935,417,509,237,426,232,213,191,28,26,185,188,65,46,37,27,28,21,13,19,13,19,0,17
14000US08069002007,"Census Tract 20.07, Larimer, CO",4640,761,2400,431,2240,422,3442,585,1814,348,1628,347,859,515,430,253,429,281,150,99,36,50,114,82,185,88,120,66,65,46,4,7,0,12,4,7
14000US08069002008,"Census Tract 20.08, Larimer, CO",4141,452,2030,269,2111,265,3586,485,1764,267,1822,276,238,141,98,65,140,111,169,95,58,49,111,71,120,82,99,78,21,23,28,23,11,18,17,20
14000US08069002010,"Census Tract 20.10, Larimer, CO",2597,266,1312,161,1285,155,2272,251,1116,134,1156,154,116,75,68,47,48,39,65,57,40,32,25,27,116,116,78,79,38,39,28,48,10,17,18,31
14000US08069002011,"Census Tract 20.11, Larimer, CO",5592,1148,2779,684,2813,536,5159,1123,2604,654,2555,544,349,224,140,96,209,134,35,57,35,57,0,17,49,57,0,17,49,57,0,17,0,17,0,17
14000US08069002300,"Census Tract 23, Larimer, CO",3603,477,1836,256,1767,277,3163,465,1577,255,1586,257,255,126,159,84,96,57,63,86,42,64,21,26,122,90,58,47,64,48,0,12,0,12,0,12
14000US08069002401,"Census Tract 24.01, Larimer, CO",1557,354,867,233,690,152,1413,347,791,226,622,149,23,35,0,12,23,35,26,38,23,37,3,7,95,79,53,49,42,36,0,12,0,12,0,12
14000US08069002503,"Census Tract 25.03, Larimer, CO",2320,247,1154,165,1166,175,2218,255,1131,169,1087,170,21,24,8,14,13,20,66,53,9,14,57,44,15,20,6,13,9,14,0,12,0,12,0,12
14000US08069002700,"Census Tract 27, Larimer, CO",6813,348,3423,296,3390,292,5842,484,2954,321,2888,340,276,285,95,84,181,209,371,240,214,150,157,111,324,268,160,157,164,118,0,17,0,17,0,17
14000US08069002801,"Census Tract 28.01, Larimer, CO",3812,443,1583,250,2229,275,3343,422,1450,255,1893,244,146,103,57,46,89,73,201,100,44,36,157,87,121,99,32,49,89,83,1,2,0,12,1,2
14000US08069002803,"Census Tract 28.03, Larimer, CO",128,94,92,100,36,31,104,97,89,100,15,14,3,6,3,6,0,12,4,11,0,12,4,11,17,25,0,12,17,25,0,12,0,12,0,12
14000US08071000100,"Census Tract 1, Las Animas, CO",3615,338,1772,204,1843,196,3148,294,1565,194,1583,163,252,151,99,58,153,113,112,60,48,33,64,44,103,54,60,41,43,31,0,12,0,12,0,12
14000US08071000200,"Census Tract 2, Las Animas, CO",1996,206,1074,141,922,115,1454,212,796,139,658,113,98,81,54,57,44,33,301,135,148,79,153,70,110,66,53,40,57,41,33,21,23,15,10,14
14000US08071000300,"Census Tract 3, Las Animas, CO",2082,275,1073,170,1009,145,1674,208,865,126,809,118,206,153,75,65,131,93,14,17,9,10,5,8,188,135,124,94,64,50,0,12,0,12,0,12
14000US08071000400,"Census Tract 4, Las Animas, CO",2226,312,1128,196,1098,165,1777,271,850,153,927,157,344,189,211,126,133,79,61,54,43,53,18,22,44,47,24,29,20,24,0,12,0,12,0,12
14000US08071000500,"Census Tract 5, Las Animas, CO",1803,242,864,168,939,135,1440,245,713,162,727,122,195,104,66,52,129,79,117,79,61,65,56,37,51,51,24,24,27,28,0,12,0,12,0,12
14000US08071000800,"Census Tract 8, Las Animas, CO",2454,330,1474,307,980,137,2175,324,1333,311,842,131,134,66,65,35,69,38,101,61,58,35,43,30,44,33,18,17,26,17,0,12,0,12,0,12
14000US08073961700,"Census Tract 9617, Lincoln, CO",3582,444,2548,537,1034,137,3371,579,2421,629,950,111,33,36,18,23,15,21,134,129,91,86,43,48,44,76,18,51,26,34,0,12,0,12,0,12
14000US08073961800,"Census Tract 9618, Lincoln, CO",1982,440,909,368,1073,108,1836,404,835,343,1001,97,85,58,46,32,39,36,53,34,28,21,25,19,8,15,0,12,8,15,0,12,0,12,0,12
14000US08075965900,"Census Tract 9659, Logan, CO",1052,146,613,114,439,70,962,128,552,96,410,70,31,30,27,30,4,5,21,14,7,8,14,10,38,36,27,28,11,10,0,12,0,12,0,12
14000US08075966000,"Census Tract 9660, Logan, CO",2291,242,1237,193,1054,137,2140,239,1183,185,957,133,107,64,33,35,74,39,21,14,9,9,12,11,23,17,12,11,11,9,0,12,0,12,0,12
14000US08075966200,"Census Tract 9662, Logan, CO",4046,654,2494,408,1552,364,2938,597,1732,316,1206,353,477,313,331,251,146,97,463,188,296,148,167,83,146,98,113,86,33,35,22,17,22,17,0,12
14000US08075966300,"Census Tract 9663, Logan, CO",5301,590,2636,431,2665,297,4499,729,2307,478,2192,358,358,163,100,52,258,127,418,272,229,151,189,149,26,29,0,17,26,29,0,17,0,17,0,17
14000US08075966400,"Census Tract 9664, Logan, CO",2160,291,1310,227,850,127,1908,295,1147,235,761,123,96,49,49,22,47,33,130,79,92,62,38,40,22,24,19,23,3,4,4,5,3,4,1,2
14000US08077000200,"Census Tract 2, Mesa, CO",2042,441,987,234,1055,264,1675,448,839,226,836,254,210,85,71,44,139,75,99,74,54,63,45,37,52,64,23,25,29,42,6,11,0,12,6,11
14000US08077000300,"Census Tract 3, Mesa, CO",1498,207,682,160,816,140,1063,181,543,139,520,108,295,140,88,54,207,114,34,33,19,21,15,17,96,71,28,31,68,64,10,14,4,7,6,8
14000US08077000400,"Census Tract 4, Mesa, CO",3653,624,1890,367,1763,394,3051,613,1537,344,1514,389,412,193,221,99,191,130,37,33,25,28,12,19,153,159,107,109,46,57,0,12,0,12,0,12
14000US08077000500,"Census Tract 5, Mesa, CO",3078,360,1459,243,1619,215,1064,252,605,182,459,107,955,209,455,138,500,139,624,146,190,68,434,102,404,122,178,69,226,78,31,30,31,30,0,12
14000US08077000601,"Census Tract 6.01, Mesa, CO",4793,905,2651,618,2142,459,3713,770,1963,500,1750,386,559,549,242,233,317,323,350,274,320,255,30,38,157,158,112,120,45,51,14,26,14,26,0,12
14000US08077000602,"Census Tract 6.02, Mesa, CO",4051,458,1907,286,2144,343,3038,420,1410,293,1628,304,546,227,316,135,230,125,248,201,120,88,128,120,207,174,61,80,146,115,12,20,0,12,12,20
14000US08077000700,"Census Tract 7, Mesa, CO",4262,483,2409,364,1853,280,3035,437,1812,312,1223,195,823,333,333,170,490,223,247,160,165,127,82,56,157,155,99,96,58,70,0,12,0,12,0,12
14000US08077000900,"Census Tract 9, Mesa, CO",3650,509,1882,383,1768,336,2446,456,1192,251,1254,301,744,324,329,147,415,195,162,92,119,71,43,32,298,280,242,274,56,50,0,12,0,12,0,12
14000US08077001001,"Census Tract 10.01, Mesa, CO",4970,742,2229,383,2741,510,4031,594,1858,328,2173,418,722,325,326,190,396,167,82,84,2,6,80,84,120,82,28,36,92,69,15,24,15,24,0,12
14000US08077001002,"Census Tract 10.02, Mesa, CO",6779,721,3081,460,3698,514,5193,774,2504,421,2689,463,1026,414,241,145,785,363,221,191,159,170,62,52,309,230,160,98,149,162,30,48,17,26,13,22
14000US08077001102,"Census Tract 11.02, Mesa, CO",4711,472,2259,258,2452,328,4049,525,1937,316,2112,310,387,261,167,124,220,148,44,53,20,25,24,32,231,156,135,92,96,84,0,12,0,12,0,12
14000US08077001200,"Census Tract 12, Mesa, CO",2265,333,1171,215,1094,166,1889,269,995,192,894,113,235,139,99,51,136,102,2,5,0,12,2,5,135,178,73,109,62,73,4,6,4,6,0,12
14000US08077001302,"Census Tract 13.02, Mesa, CO",5301,829,2490,428,2811,449,4707,915,2211,466,2496,492,395,361,171,176,224,189,199,186,108,98,91,93,0,17,0,17,0,17,0,17,0,17,0,17
14000US08077001402,"Census Tract 14.02, Mesa, CO",5533,545,2804,369,2729,323,5000,559,2449,330,2551,344,184,115,141,91,43,41,188,158,129,104,59,67,161,161,85,97,76,70,0,17,0,17,0,17
14000US08077001403,"Census Tract 14.03, Mesa, CO",3674,575,1924,373,1750,274,3291,584,1693,372,1598,279,292,180,158,102,134,89,71,70,61,64,10,16,4,8,4,8,0,12,16,18,8,13,8,12
14000US08077001404,"Census Tract 14.04, Mesa, CO",4857,460,2194,287,2663,306,4022,469,1803,254,2219,334,585,343,284,180,301,174,40,49,15,25,25,28,210,188,92,103,118,100,0,12,0,12,0,12
14000US08077001502,"Census Tract 15.02, Mesa, CO",7770,1054,4286,545,3484,696,6373,874,3444,431,2929,657,1160,534,660,298,500,297,35,40,35,40,0,17,202,222,147,166,55,61,0,17,0,17,0,17
14000US08077001600,"Census Tract 16, Mesa, CO",3848,500,1848,307,2000,253,3209,512,1562,314,1647,260,220,126,137,71,83,65,297,248,103,97,194,158,119,120,46,60,73,68,3,7,0,12,3,7
14000US08077001702,"Census Tract 17.02, Mesa, CO",4804,602,2367,267,2437,424,4201,593,2064,270,2137,408,222,112,90,50,132,76,69,56,37,32,32,30,312,128,176,99,136,79,0,12,0,12,0,12
14000US08077001703,"Census Tract 17.03, Mesa, CO",4606,507,2280,299,2326,301,3925,462,1977,274,1948,269,377,242,217,145,160,113,186,184,20,22,166,175,118,97,66,51,52,52,0,12,0,12,0,12
14000US08077001705,"Census Tract 17.05, Mesa, CO",6258,1006,3440,650,2818,532,5397,1027,2808,631,2589,542,719,391,521,308,198,123,128,130,97,94,31,49,14,23,14,23,0,17,0,17,0,17,0,17
14000US08077001706,"Census Tract 17.06, Mesa, CO",5827,1022,2544,589,3283,540,4682,1133,2104,607,2578,600,436,279,182,201,254,170,420,298,191,152,229,172,289,282,67,77,222,273,0,17,0,17,0,17
14000US08077001707,"Census Tract 17.07, Mesa, CO",5979,1014,2802,626,3177,594,4650,760,2183,489,2467,396,1054,657,545,389,509,412,158,194,34,42,124,176,74,73,40,47,34,33,43,67,0,17,43,67
14000US08077001800,"Census Tract 18, Mesa, CO",3107,424,1610,269,1497,214,2540,360,1292,202,1248,202,195,106,84,47,111,70,208,117,107,71,101,58,163,113,126,115,37,25,1,2,1,2,0,12
14000US08077001900,"Census Tract 19, Mesa, CO",5158,717,2571,360,2587,439,4890,725,2412,364,2478,441,189,129,122,92,67,51,35,46,20,23,15,23,44,47,17,22,27,31,0,17,0,17,0,17
14000US08079973600,"Census Tract 9736, Mineral, CO",841,148,386,77,455,93,675,138,322,74,353,82,9,11,1,2,8,11,31,27,18,18,13,16,122,96,41,28,81,73,4,6,4,6,0,12
14000US08081000300,"Census Tract 3, Moffat, CO",2996,325,1539,225,1457,186,2338,284,1202,167,1136,187,315,211,76,70,239,154,176,129,127,119,49,50,158,201,125,160,33,49,9,14,9,14,0,12
14000US08081000400,"Census Tract 4, Moffat, CO",4614,488,2277,329,2337,262,3791,491,1797,295,1994,276,484,301,300,213,184,108,129,77,52,48,77,47,73,56,41,38,32,30,137,69,87,50,50,24
14000US08081000500,"Census Tract 5, Moffat, CO",4267,405,2220,260,2047,258,3236,435,1651,239,1585,276,556,371,281,189,275,230,172,86,129,83,43,33,303,205,159,106,144,109,0,12,0,12,0,12
14000US08081000600,"Census Tract 6, Moffat, CO",1145,224,657,145,488,126,875,190,490,117,385,97,171,135,86,97,85,70,32,30,27,27,5,8,67,55,54,44,13,20,0,12,0,12,0,12
14000US08083941100,"Census Tract 9411, Montezuma, CO",2009,458,920,293,1089,263,1962,459,908,293,1054,261,15,16,0,12,15,16,8,16,8,16,0,12,24,26,4,6,20,23,0,12,0,12,0,12
14000US08083969000,"Census Tract 9690, Montezuma, CO",3364,437,1795,257,1569,263,3059,388,1681,243,1378,227,195,181,48,45,147,141,41,38,33,30,8,14,69,44,33,30,36,32,0,12,0,12,0,12
14000US08083969100,"Census Tract 9691, Montezuma, CO",3327,392,1762,252,1565,241,2830,381,1449,220,1381,241,189,131,124,121,65,46,215,153,123,94,92,64,90,76,66,60,24,26,3,4,0,12,3,4
14000US08083969200,"Census Tract 9692, Montezuma, CO",2709,328,1474,219,1235,172,2396,279,1319,200,1077,140,313,231,155,122,158,117,0,12,0,12,0,12,0,12,0,12,0,12,0,12,0,12,0,12
14000US08083969400,"Census Tract 9694, Montezuma, CO",3695,323,1778,229,1917,256,3208,377,1419,212,1789,274,403,219,292,166,111,88,7,11,7,11,0,12,77,66,60,52,17,19,0,12,0,12,0,12
14000US08083969600,"Census Tract 9696, Montezuma, CO",4438,631,2208,377,2230,348,4204,636,2079,381,2125,334,147,129,76,50,71,87,6,5,4,5,2,5,49,50,34,32,15,26,32,48,15,23,17,26
14000US08085966100,"Census Tract 9661, Montrose, CO",2329,295,1249,163,1080,169,2185,288,1154,159,1031,163,56,45,36,32,20,30,64,64,45,44,19,21,24,28,14,16,10,16,0,12,0,12,0,12
14000US08085966201,"Census Tract 9662.01, Montrose, CO",2485,372,1243,207,1242,229,2257,361,1090,217,1167,240,93,82,56,56,37,37,111,90,81,77,30,47,24,29,16,19,8,12,0,12,0,12,0,12
14000US08085966202,"Census Tract 9662.02, Montrose, CO",4423,649,2404,370,2019,342,3836,685,2091,403,1745,331,143,179,79,104,64,78,86,71,40,41,46,43,358,340,194,163,164,183,0,12,0,12,0,12
14000US08085966501,"Census Tract 9665.01, Montrose, CO",3053,400,1431,257,1622,260,2889,406,1325,249,1564,267,75,79,52,62,23,22,72,86,46,59,26,28,17,29,8,14,9,16,0,12,0,12,0,12
14000US08085966502,"Census Tract 9665.02, Montrose, CO",3979,509,2099,364,1880,210,3217,647,1720,408,1497,289,530,306,251,134,279,185,190,102,106,64,84,57,42,36,22,18,20,18,0,12,0,12,0,12
14000US08085966503,"Census Tract 9665.03, Montrose, CO",3566,549,1632,340,1934,321,3455,544,1602,341,1853,313,8,13,0,12,8,13,49,60,0,12,49,60,54,56,30,38,24,22,0,12,0,12,0,12
14000US08085966601,"Census Tract 9666.01, Montrose, CO",5471,600,2847,432,2624,282,4793,572,2614,419,2179,249,318,139,69,71,249,85,243,203,120,106,123,117,109,101,44,50,65,57,8,13,0,17,8,13
14000US08085966602,"Census Tract 9666.02, Montrose, CO",4354,420,2145,244,2209,265,4092,451,1999,252,2093,271,73,83,39,44,34,39,30,31,18,21,12,16,159,112,89,62,70,74,0,12,0,12,0,12
14000US08087000100,"Census Tract 1, Morgan, CO",2824,275,1614,181,1210,150,2582,271,1493,173,1089,152,101,53,47,25,54,34,63,37,45,29,18,14,72,51,29,22,43,32,6,11,0,12,6,11
14000US08087000200,"Census Tract 2, Morgan, CO",2865,355,1395,199,1470,199,2538,342,1243,201,1295,186,33,31,10,14,23,23,248,103,106,47,142,65,46,39,36,31,10,11,0,12,0,12,0,12
14000US08087000300,"Census Tract 3, Morgan, CO",1939,323,983,173,956,187,1694,316,861,162,833,189,96,57,47,29,49,30,60,44,33,26,27,26,88,88,42,41,46,50,1,3,0,12,1,3
14000US08087000400,"Census Tract 4, Morgan, CO",3872,564,2110,388,1762,265,3104,570,1679,377,1425,267,381,144,166,78,215,101,290,167,194,125,96,73,97,114,71,90,26,30,0,12,0,12,0,12
14000US08087000500,"Census Tract 5, Morgan, CO",2759,485,1500,338,1259,260,2181,527,1145,336,1036,266,251,130,138,70,113,84,206,153,116,88,90,71,121,133,101,116,20,23,0,12,0,12,0,12
14000US08087000600,"Census Tract 6, Morgan, CO",6518,775,3077,433,3441,421,4977,820,2332,437,2645,443,844,399,406,197,438,227,311,157,148,113,163,100,322,314,148,152,174,167,64,105,43,72,21,35
14000US08087000700,"Census Tract 7, Morgan, CO",5799,306,2792,297,3007,231,5257,403,2493,325,2764,255,183,206,93,132,90,83,320,168,185,150,135,87,39,36,21,22,18,29,0,17,0,17,0,17
14000US08087000800,"Census Tract 8, Morgan, CO",1593,219,871,139,722,109,1522,213,826,133,696,108,21,22,13,15,8,9,34,29,29,24,5,9,3,3,3,3,0,12,13,15,0,12,13,15
14000US08089968000,"Census Tract 9680, Otero, CO",1510,216,685,108,825,141,1210,186,536,96,674,121,148,76,67,30,81,60,91,48,41,28,50,37,61,40,41,37,20,19,0,12,0,12,0,12
14000US08089968100,"Census Tract 9681, Otero, CO",2420,346,1306,271,1114,159,2053,336,1099,257,954,153,210,174,99,87,111,108,12,18,12,18,0,12,145,144,96,99,49,67,0,12,0,12,0,12
14000US08089968200,"Census Tract 9682, Otero, CO",2686,356,1413,246,1273,173,2358,377,1282,269,1076,163,182,116,70,59,112,71,35,40,13,20,22,33,103,156,48,73,55,83,8,13,0,12,8,13
14000US08089968300,"Census Tract 9683, Otero, CO",4070,394,1824,250,2246,253,3425,395,1463,232,1962,252,297,169,153,102,144,96,192,91,97,44,95,57,140,109,111,97,29,22,16,28,0,12,16,28
14000US08089968400,"Census Tract 9684, Otero, CO",1235,231,567,112,668,169,1161,227,528,109,633,167,52,46,25,19,27,28,17,14,12,10,5,5,0,12,0,12,0,12,5,6,2,4,3,4
14000US08089968500,"Census Tract 9685, Otero, CO",1665,184,834,120,831,103,1548,179,748,111,800,104,50,33,37,25,13,15,50,46,40,38,10,12,17,19,9,14,8,10,0,12,0,12,0,12
14000US08089968600,"Census Tract 9686, Otero, CO",4453,318,2244,234,2209,262,3696,432,1774,239,1922,318,450,236,313,154,137,108,269,205,128,86,141,127,29,30,29,30,0,12,9,11,0,12,9,11
14000US08093000200,"Census Tract 2, Park, CO",4155,514,2161,283,1994,303,3742,516,2050,297,1692,291,88,87,16,20,72,72,209,128,85,69,124,88,116,73,10,14,106,66,0,12,0,12,0,12
14000US08093000300,"Census Tract 3, Park, CO",2910,465,1779,302,1131,233,2437,462,1475,287,962,238,41,34,32,28,9,10,361,147,221,110,140,99,71,83,51,56,20,34,0,12,0,12,0,12
14000US08093000400,"Census Tract 4, Park, CO",1073,247,544,155,529,149,987,240,494,150,493,149,0,12,0,12,0,12,75,60,39,18,36,60,11,18,11,18,0,12,0,12,0,12,0,12
14000US08093000500,"Census Tract 5, Park, CO",3122,547,1544,287,1578,342,2790,498,1476,285,1314,269,0,12,0,12,0,12,125,80,25,22,100,74,63,57,43,46,20,20,144,155,0,12,144,155
14000US08095967600,"Census Tract 9676, Phillips, CO",3112,165,1741,144,1371,162,2769,194,1555,139,1214,153,216,132,112,78,104,110,63,47,34,36,29,26,46,35,31,23,15,16,18,29,9,15,9,16
14000US08095967700,"Census Tract 9677, Phillips, CO",1210,165,600,90,610,120,1100,155,546,85,554,118,65,48,26,28,39,23,31,18,17,12,14,10,14,14,11,13,3,4,0,12,0,12,0,12
14000US08097000402,"Census Tract 4.02, Pitkin, CO",2030,357,962,210,1068,239,1419,286,680,152,739,207,323,164,139,102,184,101,75,66,9,15,66,59,153,106,108,98,45,51,60,78,26,35,34,46
14000US08097000500,"Census Tract 5, Pitkin, CO",3113,580,1656,374,1457,344,2638,569,1482,364,1156,319,165,133,84,63,81,82,90,119,23,36,67,116,165,152,62,81,103,99,55,87,5,9,50,79
14000US08099000100,"Census Tract 1, Prowers, CO",1383,184,682,91,701,129,1079,156,524,83,555,100,94,93,41,38,53,63,121,75,73,46,48,34,79,85,44,45,35,42,10,14,0,12,10,14
14000US08099000200,"Census Tract 2, Prowers, CO",2377,282,1338,184,1039,160,2132,298,1159,192,973,168,158,103,115,86,43,40,60,52,54,48,6,8,27,26,10,10,17,21,0,12,0,12,0,12
14000US08099000300,"Census Tract 3, Prowers, CO",4656,330,2283,208,2373,241,4167,400,2104,247,2063,239,190,181,47,36,143,154,142,102,59,48,83,73,157,122,73,71,84,61,0,12,0,12,0,12
14000US08099000600,"Census Tract 6, Prowers, CO",1290,163,662,95,628,97,1163,161,596,100,567,94,72,52,34,32,38,25,16,18,11,16,5,9,39,49,21,34,18,17,0,12,0,12,0,12
14000US08099000700,"Census Tract 7, Prowers, CO",2146,221,1078,157,1068,146,1883,225,976,167,907,127,152,101,58,49,94,69,84,69,30,39,54,55,27,29,14,18,13,16,0,12,0,12,0,12
14000US08101000100,"Census Tract 1, Pueblo, CO",2631,431,1460,297,1171,198,2380,423,1264,289,1116,196,67,84,54,76,13,17,63,51,38,39,25,27,121,97,104,85,17,25,0,12,0,12,0,12
14000US08101000200,"Census Tract 2, Pueblo, CO",1987,385,933,213,1054,207,1662,358,753,199,909,190,199,139,105,70,94,77,108,84,57,49,51,40,18,25,18,25,0,12,0,12,0,12,0,12
14000US08101000300,"Census Tract 3, Pueblo, CO",2083,463,1613,344,470,201,1756,295,1373,248,383,156,97,49,76,44,21,26,228,218,162,157,66,73,2,6,2,6,0,12,0,12,0,12,0,12
14000US08101000400,"Census Tract 4, Pueblo, CO",2499,361,1145,220,1354,291,1908,328,848,192,1060,249,267,157,125,101,142,100,251,158,130,135,121,68,59,59,34,32,25,29,14,24,8,14,6,10
14000US08101000500,"Census Tract 5, Pueblo, CO",2123,400,1022,237,1101,262,1484,283,731,190,753,186,360,329,171,158,189,182,149,104,76,67,73,63,98,88,23,24,75,67,32,57,21,34,11,25
14000US08101000600,"Census Tract 6, Pueblo, CO",2033,469,1056,350,977,165,1639,446,864,341,775,144,279,142,133,74,146,80,88,76,47,52,41,35,27,21,12,11,15,15,0,12,0,12,0,12
14000US08101000800,"Census Tract 8, Pueblo, CO",3270,658,1780,350,1490,359,2719,638,1436,335,1283,346,452,242,297,176,155,88,34,27,18,22,16,18,65,68,29,36,36,34,0,12,0,12,0,12
14000US08101000902,"Census Tract 9.02, Pueblo, CO",5976,771,3512,537,2464,334,4872,721,2722,438,2150,346,923,402,673,331,250,141,57,68,38,41,19,30,124,101,79,71,45,48,0,17,0,17,0,17
14000US08101000903,"Census Tract 9.03, Pueblo, CO",435,192,207,103,228,124,113,77,77,76,36,30,46,42,12,12,34,33,127,105,47,56,80,118,149,109,71,47,78,74,0,12,0,12,0,12
14000US08101000904,"Census Tract 9.04, Pueblo, CO",4154,595,1827,356,2327,336,3383,557,1450,345,1933,302,460,205,285,146,175,93,188,278,28,41,160,239,123,104,64,62,59,66,0,12,0,12,0,12
14000US08101000905,"Census Tract 9.05, Pueblo, CO",2043,326,1133,208,910,195,1489,304,894,205,595,152,372,188,191,106,181,112,90,59,40,27,50,43,8,14,8,14,0,12,84,121,0,12,84,121
14000US08101001000,"Census Tract 10, Pueblo, CO",4703,755,2464,554,2239,338,3947,757,2071,533,1876,325,456,226,160,112,296,146,64,57,26,28,38,42,216,136,187,126,29,26,20,29,20,29,0,12
14000US08101001100,"Census Tract 11, Pueblo, CO",2303,430,1194,254,1109,251,1956,432,1081,265,875,241,190,159,87,60,103,112,59,82,1,3,58,81,98,87,25,28,73,69,0,12,0,12,0,12
14000US08101001200,"Census Tract 12, Pueblo, CO",2130,288,809,153,1321,229,1973,299,756,147,1217,231,129,99,49,60,80,62,0,12,0,12,0,12,28,37,4,6,24,37,0,12,0,12,0,12
14000US08101001400,"Census Tract 14, Pueblo, CO",1509,251,661,156,848,198,1046,226,442,131,604,181,278,136,116,71,162,82,40,37,16,19,24,30,145,91,87,63,58,44,0,12,0,12,0,12
14000US08101001500,"Census Tract 15, Pueblo, CO",2542,455,1188,250,1354,295,2136,452,989,248,1147,285,258,114,136,60,122,76,43,45,21,26,22,22,105,69,42,44,63,46,0,12,0,12,0,12
14000US08101001600,"Census Tract 16, Pueblo, CO",1701,216,727,118,974,164,1478,215,613,111,865,166,175,140,76,54,99,92,8,10,8,10,0,12,40,32,30,27,10,10,0,12,0,12,0,12
14000US08101001700,"Census Tract 17, Pueblo, CO",4689,598,2162,354,2527,359,4217,627,1990,368,2227,356,348,206,128,93,220,148,67,64,26,31,41,38,18,27,18,27,0,12,39,49,0,12,39,49
14000US08101001800,"Census Tract 18, Pueblo, CO",2377,420,1147,297,1230,190,2088,436,1046,306,1042,162,204,135,71,54,133,120,45,34,21,28,24,16,40,39,9,12,31,29,0,12,0,12,0,12
14000US08101001900,"Census Tract 19, Pueblo, CO",1631,430,737,200,894,271,1199,417,531,175,668,270,279,157,148,96,131,79,37,34,10,12,27,24,116,83,48,40,68,56,0,12,0,12,0,12
14000US08101002000,"Census Tract 20, Pueblo, CO",3477,485,1804,362,1673,352,3125,520,1587,381,1538,355,190,137,118,94,72,58,162,152,99,91,63,65,0,12,0,12,0,12,0,12,0,12,0,12
14000US08101002100,"Census Tract 21, Pueblo, CO",1483,297,838,251,645,113,1089,172,588,130,501,106,343,254,229,194,114,71,25,43,16,28,9,15,26,47,5,10,21,38,0,12,0,12,0,12
14000US08101002200,"Census Tract 22, Pueblo, CO",1467,243,666,140,801,150,1074,258,511,140,563,150,229,91,122,54,107,63,84,83,11,16,73,72,80,55,22,18,58,42,0,12,0,12,0,12
14000US08101002300,"Census Tract 23, Pueblo, CO",3974,740,2064,495,1910,384,3012,742,1520,468,1492,376,792,362,434,203,358,196,134,116,85,91,49,57,36,29,25,24,11,15,0,12,0,12,0,12
14000US08101002400,"Census Tract 24, Pueblo, CO",1957,356,802,149,1155,280,1723,361,698,156,1025,265,89,70,50,39,39,37,88,68,44,39,44,36,53,62,10,16,43,48,4,6,0,12,4,6
14000US08101002500,"Census Tract 25, Pueblo, CO",2655,385,1483,271,1172,215,1890,377,1008,259,882,213,501,228,303,136,198,116,69,58,58,59,11,20,195,120,114,82,81,68,0,12,0,12,0,12
14000US08101002600,"Census Tract 26, Pueblo, CO",3876,683,1691,358,2185,388,2493,481,1056,255,1437,290,1033,585,462,282,571,320,158,136,100,86,58,55,174,157,64,68,110,91,18,29,9,15,9,14
14000US08101002700,"Census Tract 27, Pueblo, CO",5422,758,2467,367,2955,596,4567,729,1944,364,2623,577,640,309,382,218,258,120,195,124,141,108,54,53,20,29,0,17,20,29,0,17,0,17,0,17
14000US08101002801,"Census Tract 28.01, Pueblo, CO",5123,569,2279,402,2844,338,4295,635,1812,408,2483,352,605,257,350,165,255,139,136,167,76,97,60,76,87,82,41,39,46,43,0,17,0,17,0,17
14000US08101002802,"Census Tract 28.02, Pueblo, CO",3664,491,1808,382,1856,233,3013,418,1413,333,1600,222,496,258,284,195,212,115,17,18,17,18,0,12,138,105,94,70,44,48,0,12,0,12,0,12
14000US08101002804,"Census Tract 28.04, Pueblo, CO",4500,585,2121,313,2379,363,4389,594,2061,316,2328,368,27,26,14,16,13,21,73,70,41,47,32,37,11,20,5,10,6,10,0,12,0,12,0,12
14000US08101002806,"Census Tract 28.06, Pueblo, CO",3830,540,1986,328,1844,288,3355,540,1659,296,1696,305,284,280,170,177,114,115,120,94,120,94,0,12,71,57,37,34,34,31,0,12,0,12,0,12
14000US08101002807,"Census Tract 28.07, Pueblo, CO",4923,843,2227,406,2696,485,4630,843,2112,416,2518,471,282,192,107,89,175,124,9,12,6,11,3,6,2,5,2,5,0,12,0,12,0,12,0,12
14000US08101002808,"Census Tract 28.08, Pueblo, CO",3419,517,1840,255,1579,335,2934,399,1588,227,1346,234,465,278,243,121,222,197,0,12,0,12,0,12,20,33,9,16,11,17,0,12,0,12,0,12
14000US08101002901,"Census Tract 29.01, Pueblo, CO",3122,420,1595,272,1527,228,2223,417,1159,271,1064,204,630,244,310,146,320,144,84,90,47,48,37,45,168,163,69,54,99,119,17,27,10,15,7,13
14000US08101002906,"Census Tract 29.06, Pueblo, CO",4241,479,1996,264,2245,321,3815,491,1784,225,2031,343,202,188,109,108,93,86,87,96,20,20,67,79,103,103,59,63,44,45,34,36,24,28,10,17
14000US08101002911,"Census Tract 29.11, Pueblo, CO",2822,422,1402,178,1420,290,2676,429,1337,183,1339,290,90,65,42,32,48,36,45,42,17,17,28,28,11,15,6,9,5,7,0,12,0,12,0,12
14000US08101002912,"Census Tract 29.12, Pueblo, CO",2045,467,1106,304,939,217,1712,406,862,226,850,208,120,65,63,47,57,44,197,231,170,211,27,28,16,20,11,19,5,7,0,12,0,12,0,12
14000US08101002913,"Census Tract 29.13, Pueblo, CO",3054,285,1452,166,1602,180,2906,270,1374,161,1532,160,90,72,47,37,43,49,16,18,7,12,9,13,42,40,24,23,18,22,0,12,0,12,0,12
14000US08101002914,"Census Tract 29.14, Pueblo, CO",3385,580,1534,323,1851,322,2916,535,1312,309,1604,279,323,213,149,116,174,123,107,130,49,67,58,73,39,33,24,21,15,17,0,12,0,12,0,12
14000US08101002915,"Census Tract 29.15, Pueblo, CO",2705,389,1299,224,1406,223,2396,388,1156,213,1240,222,197,119,86,63,111,69,77,58,35,34,42,33,28,25,15,16,13,14,7,10,7,10,0,12
14000US08101002916,"Census Tract 29.16, Pueblo, CO",2787,409,1279,303,1508,264,2605,405,1202,294,1403,261,160,94,70,56,90,62,11,25,0,12,11,25,7,12,7,12,0,12,4,9,0,12,4,9
14000US08101002917,"Census Tract 29.17, Pueblo, CO",3146,382,1628,255,1518,203,2833,404,1440,252,1393,213,294,196,173,135,121,72,0,12,0,12,0,12,15,19,15,19,0,12,4,6,0,12,4,6
14000US08101003001,"Census Tract 30.01, Pueblo, CO",1589,386,681,158,908,306,1337,369,559,147,778,298,170,126,70,70,100,72,57,67,44,49,13,22,25,29,8,12,17,27,0,12,0,12,0,12
14000US08101003004,"Census Tract 30.04, Pueblo, CO",2736,324,1342,249,1394,207,2413,337,1177,236,1236,214,167,77,72,40,95,53,77,73,64,61,13,18,67,42,22,20,45,27,12,21,7,11,5,10
14000US08101003103,"Census Tract 31.03, Pueblo, CO",1854,382,1023,199,831,209,1724,373,954,195,770,213,130,88,69,57,61,49,0,12,0,12,0,12,0,12,0,12,0,12,0,12,0,12,0,12
14000US08101003104,"Census Tract 31.04, Pueblo, CO",2125,219,1013,103,1112,177,1924,203,943,105,981,158,194,109,70,43,124,89,0,12,0,12,0,12,7,12,0,12,7,12,0,12,0,12,0,12
14000US08101003105,"Census Tract 31.05, Pueblo, CO",3183,272,1545,200,1638,175,2806,273,1381,195,1425,162,265,188,91,82,174,118,85,67,46,45,39,36,20,31,20,31,0,12,7,11,7,11,0,12
14000US08101003106,"Census Tract 31.06, Pueblo, CO",1535,443,721,225,814,243,1477,432,689,215,788,239,23,21,14,16,9,10,21,30,4,9,17,29,14,27,14,27,0,12,0,12,0,12,0,12
14000US08101003200,"Census Tract 32, Pueblo, CO",3263,530,1562,319,1701,279,3124,530,1482,308,1642,288,92,118,41,67,51,56,38,41,30,37,8,13,0,12,0,12,0,12,9,14,9,14,0,12
14000US08101003500,"Census Tract 35, Pueblo, CO",1773,395,1016,276,757,184,1540,370,837,232,703,185,171,136,139,132,32,37,30,44,30,44,0,12,22,32,10,15,12,17,10,15,0,12,10,15
14000US08101003600,"Census Tract 36, Pueblo, CO",2060,308,1212,223,848,163,1838,292,1050,210,788,157,62,32,39,27,23,14,37,35,29,35,8,12,100,74,75,67,25,22,23,26,19,25,4,8
14000US08101980100,"Census Tract 9801, Pueblo, CO",0,12,0,12,0,12,0,12,0,12,0,12,0,12,0,12,0,12,0,12,0,12,0,12,0,12,0,12,0,12,0,12,0,12,0,12
14000US08103951100,"Census Tract 9511, Rio Blanco, CO",3800,263,1976,173,1824,164,3176,317,1599,216,1577,172,312,164,223,126,89,69,143,94,57,46,86,70,169,135,97,72,72,72,0,12,0,12,0,12
14000US08103951200,"Census Tract 9512, Rio Blanco, CO",2460,274,1210,156,1250,189,1924,237,943,136,981,165,173,101,58,37,115,73,187,92,106,56,81,55,174,78,101,44,73,46,2,4,2,4,0,12
14000US08105976700,"Census Tract 9767, Rio Grande, CO",4685,182,2164,169,2521,155,4238,345,1943,216,2295,230,253,248,158,155,95,100,168,142,48,57,120,95,26,43,15,35,11,25,0,12,0,12,0,12
14000US08105976800,"Census Tract 9768, Rio Grande, CO",1686,187,1010,139,676,118,1416,175,851,135,565,106,112,74,66,38,46,43,85,35,55,23,30,17,62,47,27,23,35,39,11,13,11,13,0,12
14000US08107000100,"Census Tract 1, Routt, CO",1920,264,1052,179,868,155,1685,231,895,152,790,141,127,128,92,88,35,45,29,27,5,9,24,22,75,80,56,56,19,32,4,7,4,7,0,12
14000US08107000200,"Census Tract 2, Routt, CO",2562,389,1466,242,1096,207,2251,402,1256,239,995,214,204,159,139,112,65,55,50,40,42,37,8,10,42,53,14,16,28,39,15,26,15,26,0,12
14000US08107000300,"Census Tract 3, Routt, CO",2328,313,1054,160,1274,224,2064,349,923,168,1141,240,72,68,37,37,35,33,83,53,52,36,31,29,109,114,42,59,67,66,0,12,0,12,0,12
14000US08107000400,"Census Tract 4, Routt, CO",3971,499,1862,334,2109,396,3575,469,1626,298,1949,398,60,41,26,23,34,24,266,189,175,177,91,69,70,71,35,56,35,34,0,12,0,12,0,12
14000US08107000500,"Census Tract 5, Routt, CO",4099,526,2370,384,1729,254,3407,473,1955,328,1452,224,193,136,87,75,106,97,329,228,201,137,128,105,157,100,121,81,36,46,13,26,6,13,7,13
14000US08107000600,"Census Tract 6, Routt, CO",3044,444,1654,343,1390,211,2690,421,1460,315,1230,202,92,82,25,24,67,76,164,98,119,78,45,41,91,65,50,39,41,30,7,11,0,12,7,11
14000US08107000800,"Census Tract 8, Routt, CO",2212,318,1182,189,1030,193,1911,329,1029,192,882,198,176,94,82,52,94,53,96,76,42,37,54,49,29,37,29,37,0,12,0,12,0,12,0,12
14000US08109977600,"Census Tract 9776, Saguache, CO",3419,282,1776,140,1643,199,2785,234,1506,146,1279,138,298,206,109,66,189,154,271,170,114,66,157,115,65,58,47,48,18,27,0,12,0,12,0,12
14000US08109977700,"Census Tract 9777, Saguache, CO",3204,268,1511,157,1693,162,2922,253,1382,146,1540,160,85,84,59,52,26,39,197,127,70,70,127,77,0,12,0,12,0,12,0,12,0,12,0,12
14000US08111972600,"Census Tract 9726, San Juan, CO",646,158,319,80,327,93,603,152,286,73,317,91,16,18,11,14,5,6,16,24,16,24,0,12,11,10,6,6,5,6,0,12,0,12,0,12
14000US08113968101,"Census Tract 9681.01, San Miguel, CO",1994,288,1000,184,994,175,1667,230,850,168,817,142,65,51,35,37,30,34,43,45,0,12,43,45,219,195,115,116,104,95,0,12,0,12,0,12
14000US08113968102,"Census Tract 9681.02, San Miguel, CO",1894,219,1062,146,832,125,1502,210,826,135,676,130,86,47,68,44,18,18,123,53,67,35,56,38,123,55,83,47,40,22,60,76,18,26,42,52
14000US08113968103,"Census Tract 9681.03, San Miguel, CO",2329,229,1194,135,1135,132,2085,241,1055,133,1030,144,99,85,61,49,38,40,91,103,54,67,37,40,54,42,24,21,30,28,0,12,0,12,0,12
14000US08113968200,"Census Tract 9682, San Miguel, CO",1852,201,958,138,894,116,1736,208,908,135,828,119,44,32,11,11,33,25,8,12,8,12,0,12,64,48,31,26,33,35,0,12,0,12,0,12
14000US08115968300,"Census Tract 9683, Sedgwick, CO",2231,43,1076,89,1155,105,1861,115,924,94,937,94,133,108,37,24,96,96,115,73,36,24,79,54,116,70,77,50,39,26,6,7,2,3,4,6
14000US08119010104,"Census Tract 101.04, Teller, CO",2118,284,1044,153,1074,195,1622,266,841,160,781,170,210,116,105,62,105,63,224,133,75,51,149,103,62,49,23,21,39,33,0,12,0,12,0,12
14000US08121924100,"Census Tract 9241, Washington, CO",1993,152,1086,97,907,82,1745,141,937,100,808,70,47,23,33,18,14,12,131,73,77,45,54,41,57,50,32,33,25,22,13,25,7,15,6,11
14000US08121924200,"Census Tract 9242, Washington, CO",2832,151,1469,107,1363,80,2054,192,1042,128,1012,92,202,74,110,42,92,46,525,172,278,123,247,69,51,27,39,29,12,18,0,12,0,12,0,12
14000US08123000100,"Census Tract 1, Weld, CO",2917,873,1300,293,1617,622,2150,666,1027,243,1123,477,279,131,83,62,196,105,430,263,175,116,255,170,43,56,15,29,28,38,15,23,0,12,15,23
14000US08123000200,"Census Tract 2, Weld, CO",3541,482,1596,299,1945,291,1784,286,684,145,1100,230,620,176,277,99,343,129,869,297,486,184,383,145,214,68,129,56,85,44,54,46,20,22,34,31
14000US08123000300,"Census Tract 3, Weld, CO",2288,292,844,157,1444,223,395,114,173,72,222,91,230,108,85,67,145,84,1353,267,436,167,917,197,273,92,121,62,152,76,37,34,29,30,8,16
14000US08123000401,"Census Tract 4.01, Weld, CO",3187,392,1344,238,1843,309,2689,418,1112,255,1577,307,339,126,165,77,174,83,122,74,51,38,71,50,37,34,16,17,21,20,0,12,0,12,0,12
14000US08123000402,"Census Tract 4.02, Weld, CO",4270,711,2295,461,1975,402,3486,631,2051,448,1435,310,329,194,91,57,238,182,318,221,101,79,217,154,130,81,45,43,85,72,7,11,7,11,0,12
14000US08123000501,"Census Tract 5.01, Weld, CO",3471,530,1865,377,1606,254,3115,577,1682,391,1433,259,289,179,129,101,160,120,16,25,16,25,0,12,51,76,38,57,13,19,0,12,0,12,0,12
14000US08123000502,"Census Tract 5.02, Weld, CO",3677,516,2052,338,1625,341,2839,549,1575,330,1264,341,627,352,373,252,254,155,116,89,57,55,59,44,29,27,0,12,29,27,66,104,47,73,19,31
14000US08123000600,"Census Tract 6, Weld, CO",2295,344,1713,341,582,213,890,204,569,163,321,102,878,225,723,235,155,125,373,113,308,115,65,56,136,77,95,58,41,39,18,26,18,26,0,12
14000US08123000701,"Census Tract 7.01, Weld, CO",1894,481,1038,272,856,286,1710,462,925,245,785,287,83,78,59,56,24,29,54,48,20,27,34,31,35,63,22,38,13,26,12,19,12,19,0,12
14000US08123000703,"Census Tract 7.03, Weld, CO",6576,790,3134,481,3442,487,5749,896,2684,497,3065,526,239,161,107,84,132,115,390,344,212,182,178,171,189,182,122,113,67,72,9,14,9,14,0,17
14000US08123000704,"Census Tract 7.04, Weld, CO",951,313,528,187,423,139,873,304,485,181,388,135,20,22,16,17,4,6,26,29,17,21,9,13,32,33,10,11,22,31,0,12,0,12,0,12
14000US08123000705,"Census Tract 7.05, Weld, CO",1877,343,1001,214,876,221,1731,324,933,205,798,213,40,47,21,24,19,23,28,33,22,27,6,9,70,81,25,30,45,51,8,14,0,12,8,14
14000US08123000800,"Census Tract 8, Weld, CO",3054,516,1398,235,1656,433,2236,474,1057,233,1179,375,363,152,161,70,202,109,280,149,82,64,198,121,135,83,70,53,65,45,40,38,28,31,12,23
14000US08123000900,"Census Tract 9, Weld, CO",3421,601,1844,522,1577,246,2053,446,1038,261,1015,238,807,434,402,288,405,217,208,247,208,247,0,12,349,299,192,252,157,170,4,7,4,7,0,12
14000US08123001003,"Census Tract 10.03, Weld, CO",3915,459,1796,276,2119,309,3405,409,1609,237,1796,295,188,140,52,47,136,115,262,236,97,84,165,163,60,73,38,43,22,35,0,12,0,12,0,12
14000US08123001004,"Census Tract 10.04, Weld, CO",4026,535,2158,386,1868,312,2987,432,1623,335,1364,200,470,231,268,153,202,142,451,288,223,223,228,188,118,74,44,48,74,52,0,12,0,12,0,12
14000US08123001005,"Census Tract 10.05, Weld, CO",8412,920,3915,491,4497,683,6302,1005,2950,535,3352,625,1404,777,784,408,620,398,657,437,164,109,493,407,49,60,17,29,32,36,0,17,0,17,0,17
14000US08123001006,"Census Tract 10.06, Weld, CO",5035,616,2444,394,2591,354,4493,654,2203,405,2290,354,177,125,65,56,112,97,263,147,123,71,140,107,102,94,53,59,49,47,0,17,0,17,0,17
14000US08123001100,"Census Tract 11, Weld, CO",5154,874,2641,438,2513,556,4447,699,2180,274,2267,516,402,406,199,179,203,238,180,145,170,145,10,13,103,108,83,82,20,29,22,31,9,14,13,18
14000US08123001201,"Census Tract 12.01, Weld, CO",4779,769,2443,462,2336,391,4237,751,2212,447,2025,390,309,154,97,66,212,101,164,115,98,84,66,52,45,44,34,33,11,14,24,36,2,10,22,37
14000US08123001202,"Census Tract 12.02, Weld, CO",2697,262,1181,168,1516,206,2351,310,1046,190,1305,208,242,125,124,73,118,73,18,21,5,7,13,20,80,69,0,12,80,69,6,10,6,10,0,12
14000US08123001300,"Census Tract 13, Weld, CO",7521,1030,4067,630,3454,602,6663,1044,3618,620,3045,586,465,282,242,160,223,174,175,181,42,60,133,128,142,146,121,139,21,39,76,112,44,65,32,47
14000US08123001404,"Census Tract 14.04, Weld, CO",3658,539,2038,367,1620,274,3272,526,1847,354,1425,281,177,125,96,63,81,67,51,32,20,19,31,24,140,122,57,54,83,70,18,22,18,22,0,12
14000US08123001405,"Census Tract 14.05, Weld, CO",5029,692,2519,389,2510,385,3825,673,1820,357,2005,373,695,441,357,249,338,213,312,142,167,76,145,86,157,159,135,130,22,34,40,47,40,47,0,17
14000US08123001406,"Census Tract 14.06, Weld, CO",5602,642,2765,409,2837,413,4398,727,2138,425,2260,425,634,378,309,193,325,204,201,157,153,123,48,42,369,344,165,166,204,183,0,17,0,17,0,17
14000US08123001407,"Census Tract 14.07, Weld, CO",4007,661,2017,368,1990,359,3204,690,1669,392,1535,341,453,212,202,95,251,155,162,146,72,67,90,82,188,151,74,59,114,97,0,12,0,12,0,12
14000US08123001408,"Census Tract 14.08, Weld, CO",1816,232,903,145,913,144,1475,222,706,119,769,140,274,148,168,112,106,62,52,41,21,22,31,26,15,23,8,11,7,11,0,12,0,12,0,12
14000US08123001409,"Census Tract 14.09, Weld, CO",3828,695,1858,370,1970,402,2929,550,1526,327,1403,272,487,241,181,109,306,144,7,12,7,12,0,12,405,422,144,131,261,296,0,12,0,12,0,12
14000US08123001410,"Census Tract 14.10, Weld, CO",3089,361,1398,183,1691,234,2719,352,1207,172,1512,221,266,117,116,70,150,87,54,88,54,88,0,12,50,60,21,34,29,33,0,12,0,12,0,12
14000US08123001411,"Census Tract 14.11, Weld, CO",2540,393,1206,189,1334,296,2240,350,1113,195,1127,234,122,79,50,54,72,46,29,37,29,37,0,12,149,186,14,22,135,184,0,12,0,12,0,12
14000US08123001412,"Census Tract 14.12, Weld, CO",3355,444,1641,273,1714,273,2623,369,1209,214,1414,264,386,206,221,144,165,97,300,220,187,192,113,86,46,44,24,25,22,24,0,12,0,12,0,12
14000US08123001413,"Census Tract 14.13, Weld, CO",2407,358,1169,200,1238,212,2253,368,1085,197,1168,220,23,26,23,26,0,12,103,63,48,38,55,40,28,33,13,21,15,25,0,12,0,12,0,12
14000US08123001414,"Census Tract 14.14, Weld, CO",2516,458,1305,294,1211,199,2242,454,1209,291,1033,193,204,116,73,60,131,70,50,42,13,16,37,33,20,22,10,12,10,11,0,12,0,12,0,12
14000US08123001415,"Census Tract 14.15, Weld, CO",3553,468,1830,304,1723,230,3222,476,1674,295,1548,243,160,110,79,72,81,53,116,97,41,40,75,61,55,59,36,35,19,27,0,12,0,12,0,12
14000US08123001416,"Census Tract 14.16, Weld, CO",3318,601,1817,407,1501,266,2490,287,1399,255,1091,137,575,502,369,330,206,196,246,145,42,35,204,132,0,12,0,12,0,12,7,11,7,11,0,12
14000US08123001417,"Census Tract 14.17, Weld, CO",3767,851,1819,566,1948,363,3438,873,1765,568,1673,370,234,205,19,28,215,195,84,73,24,24,60,56,11,17,11,17,0,12,0,12,0,12,0,12
14000US08123001500,"Census Tract 15, Weld, CO",7472,557,3714,338,3758,421,6860,638,3277,371,3583,424,380,370,319,327,61,58,182,187,99,97,83,93,50,65,19,31,31,37,0,17,0,17,0,17
14000US08123001600,"Census Tract 16, Weld, CO",4773,475,2472,296,2301,254,4106,499,2118,308,1988,258,334,187,164,82,170,116,125,76,75,61,50,46,208,275,115,177,93,101,0,12,0,12,0,12
14000US08123001700,"Census Tract 17, Weld, CO",6857,742,3483,413,3374,406,5984,660,2975,360,3009,384,511,175,270,102,241,93,185,102,113,72,72,44,165,145,119,90,46,65,12,11,6,9,6,7
14000US08123001800,"Census Tract 18, Weld, CO",4975,589,2562,375,2413,305,4632,605,2395,386,2237,307,140,99,81,65,59,51,145,105,62,60,83,64,58,64,24,32,34,40,0,17,0,17,0,17
14000US08123001905,"Census Tract 19.05, Weld, CO",5216,479,2810,363,2406,338,4598,499,2470,387,2128,316,100,79,49,49,51,51,455,239,262,156,193,96,50,45,16,24,34,42,13,22,13,22,0,17
14000US08123001906,"Census Tract 19.06, Weld, CO",1798,505,1017,272,781,262,1336,305,797,190,539,151,377,427,196,217,181,211,21,32,10,16,11,16,42,53,5,8,37,50,22,38,9,16,13,22
14000US08123002004,"Census Tract 20.04, Weld, CO",4872,293,2505,246,2367,255,4292,358,2202,234,2090,293,29,29,29,29,0,12,480,263,213,130,267,153,7,11,7,11,0,12,64,99,54,79,10,33
14000US08123002005,"Census Tract 20.05, Weld, CO",1308,312,645,123,663,220,1283,305,639,123,644,214,10,20,0,12,10,20,9,13,0,12,9,13,6,9,6,9,0,12,0,12,0,12,0,12
14000US08123002006,"Census Tract 20.06, Weld, CO",517,295,287,138,230,171,482,287,278,140,204,169,26,41,0,12,26,41,9,13,9,13,0,12,0,12,0,12,0,12,0,12,0,12,0,12
14000US08123002007,"Census Tract 20.07, Weld, CO",7236,497,3469,333,3767,364,6057,671,2887,335,3170,437,309,255,147,149,162,137,724,292,347,163,377,184,146,99,88,65,58,42,0,17,0,17,0,17
14000US08123002008,"Census Tract 20.08, Weld, CO",5758,456,2789,311,2969,271,5001,489,2382,332,2619,285,8,11,8,11,0,17,481,222,271,125,210,117,200,109,78,54,122,83,68,79,50,72,18,25
14000US08123002009,"Census Tract 20.09, Weld, CO",4236,501,2039,342,2197,286,3304,500,1614,303,1690,265,153,149,87,88,66,64,720,279,305,142,415,176,59,48,33,35,26,33,0,12,0,12,0,12
14000US08123002010,"Census Tract 20.10, Weld, CO",2557,347,1159,168,1398,294,2325,304,1084,167,1241,239,29,30,23,24,6,9,58,47,36,31,22,22,145,138,16,26,129,117,0,12,0,12,0,12
14000US08123002011,"Census Tract 20.11, Weld, CO",1583,288,917,207,666,125,1115,206,658,141,457,93,73,75,14,18,59,59,327,227,202,171,125,82,61,53,41,49,20,16,7,10,2,3,5,7
14000US08123002012,"Census Tract 20.12, Weld, CO",852,70,448,46,404,44,783,72,399,47,384,40,5,7,0,12,5,7,32,23,24,22,8,7,32,27,25,23,7,8,0,12,0,12,0,12
14000US08123002013,"Census Tract 20.13, Weld, CO",3026,740,1398,290,1628,479,2591,517,1258,244,1333,300,106,69,33,32,73,46,139,82,46,35,93,57,190,246,61,69,129,185,0,12,0,12,0,12
14000US08123002014,"Census Tract 20.14, Weld, CO",2105,369,1138,237,967,178,1754,327,932,194,822,181,38,29,17,14,21,20,231,122,151,105,80,49,70,47,26,23,44,31,12,17,12,17,0,12
14000US08123002015,"Census Tract 20.15, Weld, CO",956,143,527,100,429,70,866,125,491,101,375,56,16,22,10,12,6,11,74,65,26,22,48,55,0,12,0,12,0,12,0,12,0,12,0,12
14000US08123002016,"Census Tract 20.16, Weld, CO",2635,370,1210,213,1425,291,2369,359,1029,176,1340,293,29,30,29,30,0,12,237,147,152,110,85,71,0,12,0,12,0,12,0,12,0,12,0,12
14000US08123002017,"Census Tract 20.17, Weld, CO",439,77,227,41,212,47,404,75,209,39,195,47,6,8,3,4,3,4,24,24,12,14,12,12,5,9,3,4,2,5,0,12,0,12,0,12
14000US08123002018,"Census Tract 20.18, Weld, CO",1477,216,716,117,761,117,1331,225,640,119,691,121,20,23,20,23,0,12,106,78,52,37,54,47,20,20,4,6,16,17,0,12,0,12,0,12
14000US08123002019,"Census Tract 20.19, Weld, CO",5941,415,2975,285,2966,330,4935,496,2451,327,2484,311,216,137,126,81,90,84,477,239,194,121,283,154,306,205,197,147,109,71,7,12,7,12,0,17
14000US08123002020,"Census Tract 20.20, Weld, CO",5077,423,2515,243,2562,263,4366,383,2106,212,2260,255,334,203,196,126,138,92,309,127,173,70,136,68,68,90,40,50,28,42,0,17,0,17,0,17
14000US08123002021,"Census Tract 20.21, Weld, CO",796,199,470,151,326,70,694,183,421,145,273,56,65,92,33,53,32,40,37,26,16,14,21,16,0,12,0,12,0,12,0,12,0,12,0,12
14000US08123002101,"Census Tract 21.01, Weld, CO",10580,799,5383,456,5197,551,9671,880,4897,467,4774,594,693,406,419,244,274,175,127,120,48,57,79,68,89,96,19,31,70,80,0,19,0,19,0,19
14000US08123002203,"Census Tract 22.03, Weld, CO",2595,355,1414,217,1181,190,2028,210,1101,149,927,124,335,285,187,156,148,131,118,64,88,52,30,23,114,73,38,24,76,64,0,12,0,12,0,12
14000US08123002204,"Census Tract 22.04, Weld, CO",1682,170,788,92,894,121,1445,159,700,93,745,104,90,71,34,33,56,44,91,78,33,30,58,54,20,18,15,13,5,8,36,38,6,9,30,32
14000US08123002205,"Census Tract 22.05, Weld, CO",4276,404,2177,294,2099,232,3486,526,1821,302,1665,283,253,128,119,77,134,86,292,157,145,100,147,100,153,113,92,79,61,54,92,137,0,12,92,137
14000US08123002206,"Census Tract 22.06, Weld, CO",2767,256,1496,180,1271,148,2523,299,1352,195,1171,166,82,66,37,32,45,37,110,96,89,75,21,24,52,84,18,29,34,55,0,12,0,12,0,12
14000US08123002207,"Census Tract 22.07, Weld, CO",3418,504,1590,285,1828,258,2965,479,1388,277,1577,239,191,109,94,64,97,63,229,108,92,54,137,68,33,30,16,17,17,21,0,12,0,12,0,12
14000US08123002208,"Census Tract 22.08, Weld, CO",7741,518,3896,322,3845,354,6820,597,3453,356,3367,381,231,136,112,66,119,87,439,295,200,150,239,149,230,129,131,88,99,69,21,32,0,17,21,32
14000US08123002209,"Census Tract 22.09, Weld, CO",2639,298,1264,159,1375,196,2039,264,993,140,1046,169,96,54,45,31,51,39,169,109,85,54,84,63,313,257,133,118,180,149,22,34,8,11,14,23
14000US08123002210,"Census Tract 22.10, Weld, CO",1291,214,648,142,643,108,1203,218,622,143,581,105,22,18,8,8,14,12,61,48,18,14,43,38,5,8,0,12,5,8,0,12,0,12,0,12
14000US08123002300,"Census Tract 23, Weld, CO",6161,666,3075,384,3086,353,5230,618,2643,353,2587,330,498,171,216,83,282,99,376,219,188,121,188,112,44,62,19,29,25,34,13,21,9,14,4,6
14000US08123002501,"Census Tract 25.01, Weld, CO",6229,835,3002,397,3227,511,5605,818,2711,384,2894,495,303,128,167,80,136,63,203,87,43,28,160,93,118,80,81,61,37,28,0,17,0,17,0,17
14000US08123002502,"Census Tract 25.02, Weld, CO",8580,886,4421,531,4159,532,7543,894,3800,501,3743,547,711,379,467,253,244,140,261,149,105,78,156,99,57,43,41,40,16,13,8,13,8,13,0,17
14000US08125963100,"Census Tract 9631, Yuma, CO",4144,341,2067,196,2077,245,3714,321,1820,189,1894,227,135,78,77,52,58,30,207,119,118,62,89,66,51,51,30,30,21,26,37,55,22,37,15,20
14000US08125963200,"Census Tract 9632, Yuma, CO",5757,330,2922,218,2835,261,4780,427,2182,227,2598,298,466,225,369,173,97,72,72,69,62,60,10,18,189,162,121,104,68,68,250,227,188,195,62,59
